Country,Code,Year,drought_deaths,flood_deaths,earthquake_deaths,extreme_weather_deaths,extreme_temp_deaths,other_deaths,total_deaths
Afghanistan,AFG,1969,0,0,0,0,0,0,0
Afghanistan,AFG,1971,0,0,0,0,0,90778,90778
Afghanistan,AFG,2000,18933,0,0,0,0,0,18933
Afghanistan,AFG,2006,0,110836,393,27906,0,11005,150140
Afghanistan,AFG,2008,0,0,0,0,498350,0,498350
Afghanistan,AFG,2011,0,21197,0,7180,0,0,28377
Afghanistan,AFG,2018,0,27530,0,0,0,3271,30801
Afghanistan,AFG,2021,0,93767,0,0,0,4988,98755
Afghanistan,AFG,1956,0,63058,123644,0,0,0,186702
Afghanistan,AFG,1963,0,116845,0,0,0,0,116845
Afghanistan,AFG,1972,0,132899,9746,0,0,0,142645
Afghanistan,AFG,1976,0,41045,40241,0,0,0,81286
Afghanistan,AFG,1978,0,92744,0,0,0,0,92744
Afghanistan,AFG,1980,0,0,0,0,0,0,0
Afghanistan,AFG,1988,0,0,0,0,0,0,0
Afghanistan,AFG,1991,0,1110267,143320,0,74452,0,1328039
Afghanistan,AFG,1992,0,497618,11611,0,0,0,509229
Afghanistan,AFG,1995,0,16444,0,0,0,215605,232049
Afghanistan,AFG,1996,0,40920,0,0,0,0,40920
Afghanistan,AFG,1997,0,39351,2811,0,0,56215,98377
Afghanistan,AFG,1998,0,16222,3797626,0,0,37852,3851700
Afghanistan,AFG,1999,0,0,36339,0,0,0,36339
Afghanistan,AFG,2002,0,38571,571422,0,0,2381,612374
Afghanistan,AFG,2003,0,60057,442,0,0,0,60499
Afghanistan,AFG,2004,0,6793,849,0,0,0,7642
Afghanistan,AFG,2005,0,115930,2458,106509,8603,0,233500
Afghanistan,AFG,2007,0,114271,0,0,0,0,114271
Afghanistan,AFG,2009,0,25196,8034,0,0,3652,36882
Afghanistan,AFG,2010,0,47890,3902,0,0,72367,124159
Afghanistan,AFG,2012,0,48906,23961,0,14770,36433,124070
Afghanistan,AFG,2013,0,35826,5707,0,0,7609,49142
Afghanistan,AFG,2014,0,156497,0,19257,0,0,175754
Afghanistan,AFG,2015,0,2074,34071,0,0,95990,132135
Afghanistan,AFG,2016,0,24252,0,0,0,0,24252
Afghanistan,AFG,2017,0,10100,0,18797,0,34508,63405
Afghanistan,AFG,2019,0,45275,0,0,0,10591,55866
Afghanistan,AFG,2020,0,75182,0,3336,0,5645,84163
Afghanistan,AFG,2022,0,61271,258700,0,0,4620,324591
Afghanistan,AFG,2023,0,19176,1184,0,16572,0,36932
Afghanistan,AFG,1954,0,0,2543142,0,0,0,2543142
Afghanistan,AFG,1982,0,0,495624,0,0,0,495624
Afghanistan,AFG,1983,0,0,12059,0,0,0,12059
Afghanistan,AFG,1984,0,0,976,0,0,0,976
Afghanistan,AFG,1994,0,0,103523,0,0,0,103523
Afghanistan,AFG,2001,0,0,2032,0,166086,0,168118
Afghanistan,AFG,1993,0,0,0,7141,0,153530,160671
Afghanistan,AFG,1990,0,0,0,0,134645,0,134645
Afghanistan,AFG,1987,0,0,0,0,0,67811,67811
Albania,ALB,1989,0,0,0,0,0,0,0
Albania,ALB,1992,0,33296,0,0,0,0,33296
Albania,ALB,1995,0,12179,0,0,0,0,12179
Albania,ALB,1997,0,0,0,0,0,0,0
Albania,ALB,2002,0,3201,0,19209,0,0,22410
Albania,ALB,2004,0,0,0,0,9796,0,9796
Albania,ALB,2005,0,9892,0,6595,0,0,16487
Albania,ALB,2009,0,0,0,0,0,0,0
Albania,ALB,2010,0,0,0,0,0,0,0
Albania,ALB,2015,0,3469,0,0,0,0,3469
Albania,ALB,2016,0,6942,0,0,0,0,6942
Albania,ALB,2017,0,3473,0,0,20838,0,24311
Albania,ALB,2018,0,0,0,0,0,0,0
Albania,ALB,2021,0,0,0,0,0,0,0
Albania,ALB,1905,0,0,1422620,0,0,0,1422620
Albania,ALB,1920,0,0,2124900,0,0,0,2124900
Albania,ALB,1930,0,0,602740,0,0,0,602740
Albania,ALB,1931,0,0,896668,0,0,0,896668
Albania,ALB,1942,0,0,381724,0,0,0,381724
Albania,ALB,1962,0,0,82046,0,0,0,82046
Albania,ALB,1967,0,0,51584,0,0,0,51584
Albania,ALB,1979,0,0,121159,0,0,0,121159
Albania,ALB,1982,0,0,3288,0,0,0,3288
Albania,ALB,1988,0,0,0,0,0,0,0
Albania,ALB,1998,0,0,0,0,0,0,0
Albania,ALB,2019,0,0,177460,0,0,0,177460
Albania,ALB,1985,0,0,0,0,214394,179713,394107
Albania,ALB,2007,0,0,0,0,0,0,0
Albania,ALB,2012,0,0,0,0,17288,0,17288
Albania,ALB,2022,0,0,0,0,1238426,0,1238426
Algeria,DZA,1981,0,22221,0,0,0,0,22221
Algeria,DZA,1927,0,4767472,0,0,0,0,4767472
Algeria,DZA,1952,0,26256,0,0,0,0,26256
Algeria,DZA,1963,0,0,0,0,0,0,0
Algeria,DZA,1966,0,45190,0,0,0,0,45190
Algeria,DZA,1967,0,15507,7754,0,0,0,23261
Algeria,DZA,1969,0,56334,0,0,0,0,56334
Algeria,DZA,1973,0,14202,0,0,0,0,14202
Algeria,DZA,1974,0,7259,0,0,0,0,7259
Algeria,DZA,1979,0,0,0,0,0,0,0
Algeria,DZA,1982,0,18500,0,0,0,0,18500
Algeria,DZA,1984,0,25241,0,0,0,0,25241
Algeria,DZA,1985,0,11747,13554,0,0,0,25301
Algeria,DZA,1992,0,7851,0,0,0,0,7851
Algeria,DZA,1993,0,8043,0,0,0,5484,13527
Algeria,DZA,1994,0,14318,61209,0,0,7875,83402
Algeria,DZA,1996,0,1380,0,0,0,0,1380
Algeria,DZA,1997,0,1357,0,0,0,0,1357
Algeria,DZA,1999,0,3954,7250,0,0,0,11204
Algeria,DZA,2000,0,14297,0,1300,0,0,15597
Algeria,DZA,2001,0,295183,0,0,0,0,295183
Algeria,DZA,2002,0,15178,0,0,0,0,15178
Algeria,DZA,2003,0,12790,709698,4055,12478,0,739021
Algeria,DZA,2004,0,6767,0,0,0,0,6767
Algeria,DZA,2005,0,3641,0,3034,0,0,6675
Algeria,DZA,2006,0,299,1196,0,0,0,1495
Algeria,DZA,2007,0,24129,0,0,0,2354,26483
Algeria,DZA,2008,0,26902,0,0,0,0,26902
Algeria,DZA,2009,0,13638,0,0,0,0,13638
Algeria,DZA,2011,0,2736,0,0,0,0,2736
Algeria,DZA,2012,0,18518,0,0,0,0,18518
Algeria,DZA,2015,0,3035,0,0,0,0,3035
Algeria,DZA,2018,0,1431,0,0,0,0,1431
Algeria,DZA,2021,0,2943,0,0,0,20372,23315
Algeria,DZA,1910,0,0,21827,0,0,0,21827
Algeria,DZA,1946,0,0,325600,0,0,0,325600
Algeria,DZA,1954,0,0,1248558,0,0,0,1248558
Algeria,DZA,1960,0,0,50025,0,0,0,50025
Algeria,DZA,1965,0,0,1615,0,0,0,1615
Algeria,DZA,1980,0,0,1405063,0,0,0,1405063
Algeria,DZA,1987,0,0,424,0,0,0,424
Algeria,DZA,1988,0,0,0,0,0,0,0
Algeria,DZA,1989,0,0,8839,0,0,0,8839
Algeria,DZA,2014,0,0,1548,0,0,0,1548
Algeria,DZA,2020,0,0,0,0,0,0,0
Algeria,DZA,2017,0,0,0,0,0,0,0
Algeria,DZA,2019,0,0,0,0,1873,0,1873
Algeria,DZA,2022,0,0,0,0,0,9799,9799
Algeria,DZA,2023,0,0,0,0,0,7455,7455
American Samoa,ASM,2003,0,1035161,0,0,0,0,1035161
American Samoa,ASM,2009,0,0,6138736,0,0,0,6138736
American Samoa,ASM,1966,0,0,0,37271710,0,0,37271710
American Samoa,ASM,1989,0,0,0,0,0,0,0
American Samoa,ASM,2004,0,0,0,0,0,0,0
American Samoa,ASM,2005,0,0,0,0,0,0,0
Angola,AGO,1981,0,0,0,0,0,0,0
Angola,AGO,1985,0,0,0,0,0,0,0
Angola,AGO,1989,0,0,0,0,0,0,0
Angola,AGO,1997,0,0,0,0,0,0,0
Angola,AGO,2001,34235,33645,0,0,0,0,67880
Angola,AGO,2004,0,14917,0,0,0,0,14917
Angola,AGO,2012,0,0,0,0,0,0,0
Angola,AGO,2017,0,3641,0,0,0,0,3641
Angola,AGO,2020,0,9872,0,0,0,0,9872
Angola,AGO,2000,0,28059,0,0,0,7930,35989
Angola,AGO,2002,0,4567,0,0,0,0,4567
Angola,AGO,2003,0,8276,0,0,0,0,8276
Angola,AGO,2005,0,0,0,0,0,0,0
Angola,AGO,2006,0,0,0,0,0,0,0
Angola,AGO,2007,0,50216,0,0,0,0,50216
Angola,AGO,2008,0,3227,0,0,0,0,3227
Angola,AGO,2009,0,27546,0,0,0,0,27546
Angola,AGO,2010,0,10700,0,0,0,0,10700
Angola,AGO,2011,0,53588,0,0,0,0,53588
Angola,AGO,2013,0,3442,0,0,0,0,3442
Angola,AGO,2015,0,26664,0,0,0,0,26664
Angola,AGO,2016,0,38759,0,0,0,0,38759
Angola,AGO,2018,0,2558,0,0,0,0,2558
Angola,AGO,2019,0,21945,0,0,0,0,21945
Angola,AGO,2021,0,6376,0,0,0,0,6376
Angola,AGO,2023,0,14720,0,0,0,0,14720
Anguilla,AIA,1955,0,0,0,0,0,0,0
Anguilla,AIA,1960,0,0,0,8661009,0,0,8661009
Anguilla,AIA,1979,0,0,0,0,0,0,0
Anguilla,AIA,1999,0,0,0,0,0,0,0
Anguilla,AIA,2017,0,0,0,2659575,0,0,2659575
Antigua and Barbuda,ATG,1983,0,0,0,0,0,0,0
Antigua and Barbuda,ATG,1950,0,0,0,439986,0,0,439986
Antigua and Barbuda,ATG,1960,0,0,0,361298,0,0,361298
Antigua and Barbuda,ATG,1966,0,0,0,0,0,0,0
Antigua and Barbuda,ATG,1989,0,0,0,314184,0,0,314184
Antigua and Barbuda,ATG,1990,0,0,0,0,0,0,0
Antigua and Barbuda,ATG,1995,0,0,0,292325,0,0,292325
Antigua and Barbuda,ATG,1998,0,0,0,275524,0,0,275524
Antigua and Barbuda,ATG,1999,0,0,0,270882,0,0,270882
Antigua and Barbuda,ATG,2008,0,0,0,0,0,0,0
Antigua and Barbuda,ATG,2010,0,0,0,0,0,0,0
Antigua and Barbuda,ATG,2017,0,0,0,109730,0,0,109730
Argentina,ARG,2003,0,7054,0,3135,0,0,10189
Argentina,ARG,2009,0,2212,0,2458,0,983,5653
Argentina,ARG,2018,0,0,0,450,0,0,450
Argentina,ARG,2019,1788,1341,0,0,0,0,3129
Argentina,ARG,1958,0,182784,0,0,0,0,182784
Argentina,ARG,1966,0,27675,0,0,0,0,27675
Argentina,ARG,1967,0,24608,0,0,0,0,24608
Argentina,ARG,1970,0,15099,0,0,0,0,15099
Argentina,ARG,1977,0,0,26204,0,0,0,26204
Argentina,ARG,1978,0,0,0,1842,0,0,1842
Argentina,ARG,1979,0,0,0,0,0,0,0
Argentina,ARG,1980,0,14630,0,0,0,0,14630
Argentina,ARG,1982,0,0,0,0,0,0,0
Argentina,ARG,1983,0,0,0,0,0,0,0
Argentina,ARG,1985,0,12216,1981,0,0,0,14197
Argentina,ARG,1986,0,976,0,325,0,0,1301
Argentina,ARG,1987,0,0,0,320,0,0,320
Argentina,ARG,1988,0,7889,0,0,0,0,7889
Argentina,ARG,1990,0,6434,0,0,0,0,6434
Argentina,ARG,1992,0,13406,0,0,0,0,13406
Argentina,ARG,1993,0,0,0,4408,0,0,4408
Argentina,ARG,1995,0,0,0,1717,0,0,1717
Argentina,ARG,1997,0,0,0,0,0,0,0
Argentina,ARG,1998,0,5244,0,0,0,0,5244
Argentina,ARG,2000,0,3507,0,270,4046,2158,9981
Argentina,ARG,2001,0,267,0,5336,3735,0,9338
Argentina,ARG,2002,0,1056,0,792,0,0,1848
Argentina,ARG,2004,0,1293,0,0,1293,0,2586
Argentina,ARG,2006,0,0,0,0,0,0,0
Argentina,ARG,2007,0,2508,0,0,2257,0,4765
Argentina,ARG,2008,0,0,0,0,0,0,0
Argentina,ARG,2012,0,1430,0,4529,0,0,5959
Argentina,ARG,2013,0,12268,0,944,0,0,13212
Argentina,ARG,2014,0,701,0,0,0,5604,6305
Argentina,ARG,2015,0,2543,0,1849,0,0,4392
Argentina,ARG,2016,0,0,0,0,0,0,0
Argentina,ARG,2017,0,227,0,0,0,0,227
Argentina,ARG,2020,0,666,0,0,0,0,666
Argentina,ARG,2021,0,0,0,0,0,3313,3313
Argentina,ARG,2023,0,0,0,0,0,0,0
Argentina,ARG,1920,0,0,453599,0,0,0,453599
Argentina,ARG,1944,0,0,6586768,0,0,0,6586768
Argentina,ARG,1973,0,0,0,23980,0,0,23980
Argentina,ARG,1974,0,0,0,39293,0,0,39293
Argentina,ARG,1975,0,0,0,7729,0,0,7729
Argentina,ARG,2005,0,0,0,2815,0,0,2815
Argentina,ARG,1972,0,0,0,0,40629,0,40629
Argentina,ARG,2010,0,0,0,0,10219,0,10219
Argentina,ARG,1991,0,0,0,0,0,0,0
Argentina,ARG,2011,0,0,0,0,0,0,0
Argentina,ARG,1965,0,0,0,0,0,20405,20405
Argentina,ARG,1984,0,0,0,0,0,10056,10056
Argentina,ARG,1994,0,0,0,0,0,6959,6959
Argentina,ARG,1999,0,0,0,0,0,0,0
Argentina,ARG,2022,0,0,0,0,0,0,0
Armenia,ARM,2000,0,0,0,0,0,0,0
Armenia,ARM,1997,0,12227,0,0,0,0,12227
Armenia,ARM,1998,0,0,0,0,0,0,0
Armenia,ARM,2004,0,3262,0,0,0,0,3262
Armenia,ARM,1931,0,0,25175049,0,0,0,25175049
Armenia,ARM,2013,0,0,0,0,0,0,0
Armenia,ARM,2018,0,0,0,0,0,0,0
Armenia,ARM,2019,0,0,0,0,0,0,0
Armenia,ARM,2020,0,0,0,0,0,0,0
Armenia,ARM,2023,0,0,0,0,0,0,0
Armenia,ARM,2016,0,0,0,0,0,0,0
Australia,AUS,1967,508082,0,0,0,0,52502,560584
Australia,AUS,1974,0,10209,0,55420,0,0,65629
Australia,AUS,1976,0,0,0,0,0,0,0
Australia,AUS,1978,0,4876,0,3483,0,0,8359
Australia,AUS,1981,0,1340,0,0,0,0,1340
Australia,AUS,1991,0,0,0,0,0,0,0
Australia,AUS,1992,0,0,0,1145,0,0,1145
Australia,AUS,2002,0,0,0,0,0,1027,1027
Australia,AUS,2006,0,0,0,0,0,1954,1954
Australia,AUS,2018,0,0,0,0,0,0,0
Australia,AUS,1955,0,76006,0,0,0,0,76006
Australia,AUS,1971,0,20779,0,2309,0,0,23088
Australia,AUS,1973,0,8880,0,0,0,0,8880
Australia,AUS,1984,0,23107,0,0,0,0,23107
Australia,AUS,1986,0,4996,0,4372,0,0,9368
Australia,AUS,1988,0,9682,0,605,0,0,10287
Australia,AUS,1989,0,5358,7144,7144,0,0,19646
Australia,AUS,1990,0,7039,0,0,0,0,7039
Australia,AUS,1993,0,567,0,0,9642,0,10209
Australia,AUS,1996,0,2745,0,3844,0,4942,11531
Australia,AUS,1997,0,0,0,0,0,11407,11407
Australia,AUS,1998,0,10752,0,0,0,0,10752
Australia,AUS,2000,0,0,0,526,0,0,526
Australia,AUS,2001,0,2078,0,1039,0,0,3117
Australia,AUS,2003,0,508,0,508,0,2031,3047
Australia,AUS,2004,0,1506,0,1506,0,0,3012
Australia,AUS,2005,0,1487,0,496,0,5949,7932
Australia,AUS,2007,0,4321,0,960,0,0,5281
Australia,AUS,2008,0,3294,0,471,0,0,3765
Australia,AUS,2009,0,3232,0,462,160197,83099,246990
Australia,AUS,2010,0,15895,0,454,0,0,16349
Australia,AUS,2011,0,0,0,447,0,0,447
Australia,AUS,2012,0,1760,0,0,0,0,1760
Australia,AUS,2015,0,2519,0,3358,0,840,6717
Australia,AUS,2016,0,413,0,2066,0,827,3306
Australia,AUS,2019,0,1183,0,0,0,12620,13803
Australia,AUS,2020,0,390,0,0,0,0,390
Australia,AUS,2021,0,2315,0,386,0,0,2701
Australia,AUS,2022,0,11842,0,0,0,0,11842
Australia,AUS,2023,0,0,0,0,0,0,0
Australia,AUS,1968,0,0,0,0,0,9977,9977
Australia,AUS,1994,0,0,0,15164,2808,2246,20218
Australia,AUS,1970,0,0,0,10322,0,0,10322
Australia,AUS,1979,0,0,0,10330,0,0,10330
Australia,AUS,1982,0,0,0,659,0,0,659
Australia,AUS,1985,0,0,0,17104,0,6968,24072
Australia,AUS,1995,0,0,0,4444,555,0,4999
Australia,AUS,1999,0,0,0,3723,0,532,4255
Australia,AUS,2013,0,0,0,2596,0,1298,3894
Australia,AUS,2014,0,0,0,0,59226,852,60078
Australia,AUS,2017,0,0,0,4880,0,0,4880
Australia,AUS,1939,0,0,0,0,0,103081,103081
Australia,AUS,1944,0,0,0,0,0,66244,66244
Australia,AUS,1977,0,0,0,0,0,2114,2114
Australia,AUS,1983,0,0,0,0,0,48755,48755
Austria,AUT,1980,0,0,0,0,0,0,0
Austria,AUT,1982,0,0,0,0,0,15849,15849
Austria,AUT,1983,0,0,0,0,0,0,0
Austria,AUT,1985,0,15869,0,0,0,0,15869
Austria,AUT,1991,0,6447,0,0,0,0,6447
Austria,AUT,1995,0,2517,0,0,0,0,2517
Austria,AUT,1996,0,0,0,0,0,0,0
Austria,AUT,1997,0,3765,0,0,0,0,3765
Austria,AUT,1999,0,3754,0,0,0,62567,66321
Austria,AUT,2002,0,11140,0,3713,0,0,14853
Austria,AUT,2005,0,4862,0,0,0,0,4862
Austria,AUT,2006,0,0,0,0,0,0,0
Austria,AUT,2009,0,1199,0,0,2397,0,3596
Austria,AUT,2013,0,4717,0,0,0,0,4717
Austria,AUT,2016,0,0,0,0,0,0,0
Austria,AUT,2021,0,1121,0,0,0,0,1121
Austria,AUT,1998,0,0,0,0,0,0,0
Austria,AUT,1976,0,0,0,0,0,0,0
Austria,AUT,1981,0,0,0,0,0,0,0
Austria,AUT,1984,0,0,0,15876,0,39690,55566
Austria,AUT,1990,0,0,0,3907,0,0,3907
Austria,AUT,1993,0,0,0,0,0,0,0
Austria,AUT,1994,0,0,0,0,0,0,0
Austria,AUT,2000,0,0,0,0,0,16229,16229
Austria,AUT,2007,0,0,0,0,6028,0,6028
Austria,AUT,2008,0,0,0,4807,0,0,4807
Austria,AUT,2017,0,0,0,5683,0,0,5683
Austria,AUT,2019,0,0,0,12387,1126,0,13513
Austria,AUT,2022,0,0,0,0,468700,0,468700
Austria,AUT,2003,0,0,0,0,424871,0,424871
Austria,AUT,2012,0,0,0,0,5931,0,5931
Austria,AUT,1952,0,0,0,0,0,40421,40421
Austria,AUT,1954,0,0,0,0,0,302609,302609
Austria,AUT,1975,0,0,0,0,0,19797,19797
Austria,AUT,2023,0,0,0,0,0,8930,8930
Azerbaijan,AZE,2000,0,0,37849,0,0,13430,51279
Azerbaijan,AZE,1995,0,6338,0,0,0,0,6338
Azerbaijan,AZE,1997,0,13750,0,0,0,0,13750
Azerbaijan,AZE,2003,0,0,0,0,0,0,0
Azerbaijan,AZE,2009,0,0,0,0,0,0,0
Azerbaijan,AZE,2010,0,3248,0,0,0,0,3248
Azerbaijan,AZE,1998,0,0,1244,0,0,0,1244
Azerbaijan,AZE,1999,0,0,1234,0,0,0,1234
Azerbaijan,AZE,2012,0,0,0,0,5271,0,5271
Bahamas,BHS,1988,0,0,0,0,0,0,0
Bahamas,BHS,2013,0,0,0,0,0,0,0
Bahamas,BHS,1926,0,0,0,0,0,0,0
Bahamas,BHS,1929,0,0,0,0,0,0,0
Bahamas,BHS,1935,0,0,0,1930502,0,0,1930502
Bahamas,BHS,1945,0,0,0,2799232,0,0,2799232
Bahamas,BHS,1963,0,0,0,0,0,0,0
Bahamas,BHS,1965,0,0,0,0,0,0,0
Bahamas,BHS,1966,0,0,0,330375,0,0,330375
Bahamas,BHS,1990,0,0,0,0,0,0,0
Bahamas,BHS,1992,0,0,0,141853,0,0,141853
Bahamas,BHS,1995,0,0,0,0,0,0,0
Bahamas,BHS,1999,0,0,0,31222,0,0,31222
Bahamas,BHS,2001,0,0,0,0,0,0,0
Bahamas,BHS,2004,0,0,0,349755,0,0,349755
Bahamas,BHS,2005,0,0,0,28751,0,0,28751
Bahamas,BHS,2007,0,0,0,27958,0,0,27958
Bahamas,BHS,2008,0,0,0,0,0,0,0
Bahamas,BHS,2011,0,0,0,0,0,0,0
Bahamas,BHS,2012,0,0,0,26173,0,0,26173
Bahamas,BHS,2015,0,0,0,840321,0,0,840321
Bahamas,BHS,2016,0,0,0,0,0,0,0
Bahamas,BHS,2017,0,0,0,0,0,0,0
Bahamas,BHS,2019,0,0,0,8799619,0,0,8799619
Bangladesh,BGD,1943,510182500,0,0,0,0,0,510182500
Bangladesh,BGD,1947,0,0,0,129820,0,0,129820
Bangladesh,BGD,1974,0,3934320,0,383836,0,0,4318156
Bangladesh,BGD,1979,2198,0,0,6471,0,0,8669
Bangladesh,BGD,1982,0,0,0,0,0,0,0
Bangladesh,BGD,1989,0,17160,95,77698,16207,0,111160
Bangladesh,BGD,2009,0,1091,0,13428,9202,0,23721
Bangladesh,BGD,1960,0,1984268,0,1616980,0,0,3601248
Bangladesh,BGD,1963,0,5445,0,4007506,0,0,4012951
Bangladesh,BGD,1964,0,0,0,52841,0,0,52841
Bangladesh,BGD,1966,0,6471,0,141043,0,0,147514
Bangladesh,BGD,1968,0,34534,0,18439,0,0,52973
Bangladesh,BGD,1970,0,0,0,44463830,0,0,44463830
Bangladesh,BGD,1972,0,7210,0,28841,0,0,36051
Bangladesh,BGD,1973,0,60018,0,267061,0,0,327079
Bangladesh,BGD,1976,0,21995,0,6153,0,0,28148
Bangladesh,BGD,1977,0,1664,0,81139,0,0,82803
Bangladesh,BGD,1978,0,2125,0,128738,0,0,130863
Bangladesh,BGD,1980,0,78041,0,1311,0,0,79352
Bangladesh,BGD,1983,0,26910,0,75237,0,0,102147
Bangladesh,BGD,1984,0,128295,0,0,0,0,128295
Bangladesh,BGD,1985,0,3543,0,1575775,0,0,1579318
Bangladesh,BGD,1986,0,3053,0,18724,0,0,21777
Bangladesh,BGD,1987,0,226888,0,1194,0,0,228082
Bangladesh,BGD,1988,0,237611,195,103614,0,0,341420
Bangladesh,BGD,1990,0,21559,0,62904,10920,0,95383
Bangladesh,BGD,1991,0,24258,0,12722757,16660,0,12763675
Bangladesh,BGD,1992,0,1528,0,2067,0,0,3595
Bangladesh,BGD,1993,0,17105,0,39852,0,0,56957
Bangladesh,BGD,1994,0,10033,0,17731,2508,0,30272
Bangladesh,BGD,1995,0,62907,0,63926,10187,0,137020
Bangladesh,BGD,1996,0,4588,0,52220,16684,0,73492
Bangladesh,BGD,1997,0,6473,1885,34825,2704,0,45887
Bangladesh,BGD,1998,0,84439,0,25814,9650,0,119903
Bangladesh,BGD,1999,0,15463,473,10098,0,0,26034
Bangladesh,BGD,2000,0,3328,0,7663,3793,0,14784
Bangladesh,BGD,2001,0,684,0,18075,456,0,19215
Bangladesh,BGD,2002,0,745,0,9095,52184,0,62024
Bangladesh,BGD,2003,0,18461,147,4396,15751,0,38755
Bangladesh,BGD,2004,0,54831,144,17220,0,0,72195
Bangladesh,BGD,2005,0,3903,0,12561,7097,0,23561
Bangladesh,BGD,2006,0,0,0,10797,0,0,10797
Bangladesh,BGD,2007,0,85336,0,296595,9019,0,390950
Bangladesh,BGD,2008,0,1925,0,1857,0,894,4676
Bangladesh,BGD,2010,0,1011,0,1752,0,4448,7211
Bangladesh,BGD,2011,0,666,0,865,4128,1132,6791
Bangladesh,BGD,2012,0,9139,0,8745,4734,0,22618
Bangladesh,BGD,2014,0,3783,0,1282,0,0,5065
Bangladesh,BGD,2015,0,1964,253,7413,0,444,10074
Bangladesh,BGD,2016,0,6634,313,5445,0,0,12392
Bangladesh,BGD,2017,0,8900,0,1174,0,9889,19963
Bangladesh,BGD,2018,0,2138,0,2016,2077,0,6231
Bangladesh,BGD,2019,0,6888,0,5679,3021,121,15709
Bangladesh,BGD,2020,0,15351,0,1553,0,0,16904
Bangladesh,BGD,2021,0,1240,0,177,0,0,1417
Bangladesh,BGD,2022,0,8237,0,2045,0,0,10282
Bangladesh,BGD,1904,0,0,0,0,0,0,0
Bangladesh,BGD,1909,0,0,0,61810,0,0,61810
Bangladesh,BGD,1911,0,0,0,0,0,0,0
Bangladesh,BGD,1919,0,0,0,0,0,0,0
Bangladesh,BGD,1922,0,0,0,0,0,0,0
Bangladesh,BGD,1923,0,0,0,2071,0,0,2071
Bangladesh,BGD,1926,0,0,0,0,0,0,0
Bangladesh,BGD,1937,0,0,0,0,0,0,0
Bangladesh,BGD,1941,0,0,0,1368396,0,0,1368396
Bangladesh,BGD,1942,0,0,0,16517802,0,0,16517802
Bangladesh,BGD,1951,0,0,0,49324,0,0,49324
Bangladesh,BGD,1958,0,0,0,104728,0,0,104728
Bangladesh,BGD,1961,0,0,0,2171433,0,0,2171433
Bangladesh,BGD,1965,0,0,0,8362542,0,0,8362542
Bangladesh,BGD,1967,0,0,0,14653,0,0,14653
Bangladesh,BGD,1969,0,0,0,128896,0,0,128896
Bangladesh,BGD,1971,0,0,0,23839,0,0,23839
Bangladesh,BGD,1981,0,0,0,125936,0,0,125936
Bangladesh,BGD,2013,0,0,0,3246,0,0,3246
Bangladesh,BGD,2023,0,0,0,752,0,0,752
Barbados,BRB,2010,0,0,0,0,0,0,0
Barbados,BRB,1970,0,124274,0,0,0,0,124274
Barbados,BRB,1984,0,0,0,0,0,0,0
Barbados,BRB,2007,0,0,0,0,0,0,0
Barbados,BRB,1955,0,0,0,2507368,0,0,2507368
Barbados,BRB,1980,0,0,0,0,0,0,0
Barbados,BRB,1987,0,0,0,0,0,0,0
Barbados,BRB,1995,0,0,0,0,0,0,0
Barbados,BRB,2002,0,0,0,0,0,0,0
Barbados,BRB,2004,0,0,0,37242,0,0,37242
Barbados,BRB,2017,0,0,0,35817,0,0,35817
Barbados,BRB,2021,0,0,0,0,0,0,0
Barbados,BRB,2023,0,0,0,0,0,0,0
Belarus,BLR,1993,0,0,0,0,0,0,0
Belarus,BLR,1996,0,0,0,0,0,0,0
Belarus,BLR,1999,0,1940,0,0,0,0,1940
Belarus,BLR,2018,0,0,0,0,0,0,0
Belarus,BLR,2023,0,0,0,0,0,0,0
Belarus,BLR,1997,0,0,0,4807,0,0,4807
Belarus,BLR,2007,0,0,0,0,0,0,0
Belarus,BLR,2000,0,0,0,0,0,0,0
Belarus,BLR,2005,0,0,0,0,5033,0,5033
Belarus,BLR,2012,0,0,0,0,0,0,0
Belarus,BLR,2013,0,0,0,0,4127,0,4127
Belarus,BLR,2014,0,0,0,0,2063,0,2063
Belarus,BLR,2017,0,0,0,0,44294,0,44294
Belgium,BEL,1976,0,0,0,0,0,0,0
Belgium,BEL,1906,0,8386,0,0,0,0,8386
Belgium,BEL,1928,0,0,0,0,0,0,0
Belgium,BEL,1953,0,12585,0,0,0,0,12585
Belgium,BEL,1956,0,4504,0,0,0,0,4504
Belgium,BEL,1971,0,0,0,0,0,0,0
Belgium,BEL,1993,0,0,0,0,0,0,0
Belgium,BEL,1994,0,0,0,0,0,0,0
Belgium,BEL,1998,0,981,0,0,0,0,981
Belgium,BEL,2002,0,1931,0,4828,0,0,6759
Belgium,BEL,2003,0,0,0,0,1129531,0,1129531
Belgium,BEL,2005,0,0,0,0,1902,0,1902
Belgium,BEL,2010,0,2758,0,919,0,0,3677
Belgium,BEL,2011,0,0,0,4564,0,0,4564
Belgium,BEL,2016,0,884,0,884,0,0,1768
Belgium,BEL,2021,0,33588,0,0,0,0,33588
Belgium,BEL,1983,0,0,2027,0,0,0,2027
Belgium,BEL,1992,0,0,0,0,0,0,0
Belgium,BEL,1930,0,0,0,74724,0,0,74724
Belgium,BEL,1967,0,0,0,0,0,0,0
Belgium,BEL,1972,0,0,0,0,0,0,0
Belgium,BEL,1984,0,0,0,0,0,0,0
Belgium,BEL,1985,0,0,0,0,0,0,0
Belgium,BEL,1990,0,0,0,16065,0,0,16065
Belgium,BEL,1995,0,0,0,5943,0,0,5943
Belgium,BEL,1999,0,0,0,1956,0,0,1956
Belgium,BEL,2007,0,0,0,1877,0,0,1877
Belgium,BEL,2008,0,0,0,0,932,0,932
Belgium,BEL,2013,0,0,0,0,0,0,0
Belgium,BEL,2014,0,0,0,0,0,0,0
Belgium,BEL,2018,0,0,0,873,0,0,873
Belgium,BEL,2020,0,0,0,0,1459126,0,1459126
Belgium,BEL,2022,0,0,0,1716,372343,0,374059
Belgium,BEL,1963,0,0,0,0,12920,0,12920
Belgium,BEL,2006,0,0,0,0,888219,0,888219
Belgium,BEL,2012,0,0,0,0,2720,0,2720
Belgium,BEL,2015,0,0,0,0,364499,0,364499
Belgium,BEL,2019,0,0,0,0,622037,0,622037
Belize,BLZ,1979,0,0,0,0,0,0,0
Belize,BLZ,1990,0,0,0,0,0,0,0
Belize,BLZ,1995,0,0,0,0,0,0,0
Belize,BLZ,2008,0,32713,0,228992,0,0,261705
Belize,BLZ,2015,0,0,0,0,0,0,0
Belize,BLZ,1931,0,0,0,279668120,0,0,279668120
Belize,BLZ,1955,0,0,0,1999875,0,0,1999875
Belize,BLZ,1961,0,0,0,29325827,0,0,29325827
Belize,BLZ,1974,0,0,0,0,0,0,0
Belize,BLZ,1978,0,0,0,359844,0,0,359844
Belize,BLZ,1998,0,0,0,400148,0,0,400148
Belize,BLZ,2000,0,0,0,582314,0,0,582314
Belize,BLZ,2001,0,0,0,1209146,0,0,1209146
Belize,BLZ,2005,0,0,0,106995,0,0,106995
Belize,BLZ,2007,0,0,0,0,0,0,0
Belize,BLZ,2010,0,0,0,0,0,0,0
Belize,BLZ,2016,0,0,0,0,0,0,0
Belize,BLZ,2020,0,0,0,0,0,0,0
Belize,BLZ,2022,0,0,0,0,0,0,0
Benin,BEN,1969,0,0,0,0,0,0,0
Benin,BEN,1980,0,0,0,0,0,0,0
Benin,BEN,1970,0,0,0,0,0,0,0
Benin,BEN,1982,0,0,0,0,0,0,0
Benin,BEN,1985,0,138023,0,0,0,0,138023
Benin,BEN,1988,0,0,0,0,0,0,0
Benin,BEN,1991,0,5668,0,0,0,0,5668
Benin,BEN,1994,0,0,0,0,0,0,0
Benin,BEN,1995,0,33077,0,0,0,0,33077
Benin,BEN,1996,0,17731,0,0,0,0,17731
Benin,BEN,1997,0,0,0,0,0,0,0
Benin,BEN,1998,0,0,0,0,0,0,0
Benin,BEN,1999,0,4419,0,0,0,0,4419
Benin,BEN,2007,0,11564,0,0,0,0,11564
Benin,BEN,2008,0,16842,0,0,0,0,16842
Benin,BEN,2009,0,10902,0,0,0,0,10902
Benin,BEN,2010,0,48699,0,0,0,0,48699
Benin,BEN,2011,0,0,0,0,0,0,0
Benin,BEN,2012,0,3994,0,0,0,0,3994
Benin,BEN,2013,0,0,0,0,0,970,970
Benin,BEN,2020,0,4746,0,0,0,0,4746
Benin,BEN,2021,0,10002,0,0,0,0,10002
Benin,BEN,2022,0,32952,0,0,0,0,32952
Benin,BEN,1978,0,0,0,0,0,5499,5499
Benin,BEN,1984,0,0,0,0,0,0,0
Bermuda,BMU,1985,0,0,0,0,0,0,0
Bermuda,BMU,1986,0,0,0,0,0,0,0
Bermuda,BMU,1987,0,0,0,0,0,0,0
Bermuda,BMU,1989,0,0,0,0,0,0,0
Bermuda,BMU,2003,0,0,0,640102,0,0,640102
Bhutan,BTN,1994,0,422048,0,326128,0,0,748176
Bhutan,BTN,2000,0,3405936,0,0,0,0,3405936
Bhutan,BTN,2004,0,0,0,0,0,0,0
Bhutan,BTN,2021,0,128617,0,0,0,0,128617
Bhutan,BTN,2009,0,0,157665,171998,0,0,329663
Bhutan,BTN,2011,0,0,14019,0,0,0,14019
Bhutan,BTN,1999,0,0,0,0,0,0,0
Bolivia,BOL,1977,0,18643,0,0,0,0,18643
Bolivia,BOL,1983,0,408455,0,0,0,0,408455
Bolivia,BOL,1988,0,0,0,0,0,0,0
Bolivia,BOL,1990,0,0,0,0,0,0,0
Bolivia,BOL,1994,0,0,6499,0,0,0,6499
Bolivia,BOL,2000,0,34914,0,0,6983,0,41897
Bolivia,BOL,2004,0,0,0,0,0,0,0
Bolivia,BOL,2008,0,0,0,0,0,0,0
Bolivia,BOL,2010,0,25432,0,0,3913,0,29345
Bolivia,BOL,2013,0,92150,0,0,16755,17685,126590
Bolivia,BOL,2014,0,57708,0,0,0,67784,125492
Bolivia,BOL,2016,0,3551,0,0,0,0,3551
Bolivia,BOL,1965,0,97193,0,0,0,0,97193
Bolivia,BOL,1966,0,33301,0,0,0,0,33301
Bolivia,BOL,1968,0,54679,0,0,0,0,54679
Bolivia,BOL,1974,0,61830,0,0,0,0,61830
Bolivia,BOL,1978,0,72911,0,0,0,0,72911
Bolivia,BOL,1980,0,0,0,0,0,0,0
Bolivia,BOL,1982,0,0,0,0,0,0,0
Bolivia,BOL,1984,0,0,0,0,0,0,0
Bolivia,BOL,1985,0,0,0,0,0,0,0
Bolivia,BOL,1986,0,44465,0,0,0,0,44465
Bolivia,BOL,1987,0,37529,0,0,0,0,37529
Bolivia,BOL,1992,0,5409,0,0,0,66266,71675
Bolivia,BOL,1997,0,68816,0,0,0,0,68816
Bolivia,BOL,1999,0,0,0,0,0,3555,3555
Bolivia,BOL,2001,0,46878,0,0,10290,0,57168
Bolivia,BOL,2002,0,85388,0,22470,0,0,107858
Bolivia,BOL,2003,0,81701,0,0,0,76181,157882
Bolivia,BOL,2006,0,26198,0,0,0,0,26198
Bolivia,BOL,2007,0,118421,0,0,0,0,118421
Bolivia,BOL,2009,0,0,0,0,0,0,0
Bolivia,BOL,2011,0,50018,0,0,0,0,50018
Bolivia,BOL,2012,0,12299,0,0,0,0,12299
Bolivia,BOL,2015,0,0,0,0,0,0,0
Bolivia,BOL,2018,0,5169,0,0,0,0,5169
Bolivia,BOL,2019,0,50945,0,0,0,19529,70474
Bolivia,BOL,2020,0,21783,0,0,0,4189,25972
Bolivia,BOL,2021,0,41393,0,0,0,0,41393
Bolivia,BOL,2022,0,49083,0,0,0,0,49083
Bolivia,BOL,2023,0,6458,0,0,0,0,6458
Bolivia,BOL,1998,0,0,114638,0,0,72403,187041
Bolivia,BOL,1996,0,0,0,0,0,50067,50067
Bolivia,BOL,2005,0,0,0,0,0,0,0
Bosnia and Herzegovina,BIH,2000,0,0,0,0,0,14356,14356
Bosnia and Herzegovina,BIH,2003,0,0,0,0,0,0,0
Bosnia and Herzegovina,BIH,2001,0,0,0,0,0,0,0
Bosnia and Herzegovina,BIH,2004,0,0,0,0,0,0,0
Bosnia and Herzegovina,BIH,2005,0,0,0,9770,0,0,9770
Bosnia and Herzegovina,BIH,2009,0,0,0,0,2579,0,2579
Bosnia and Herzegovina,BIH,2010,0,7872,0,0,5248,0,13120
Bosnia and Herzegovina,BIH,2014,0,72807,0,0,0,0,72807
Bosnia and Herzegovina,BIH,2015,0,0,0,0,0,0,0
Bosnia and Herzegovina,BIH,2019,0,2976,0,0,0,0,2976
Bosnia and Herzegovina,BIH,2020,0,0,0,0,0,0,0
Bosnia and Herzegovina,BIH,2021,0,0,0,0,0,0,0
Bosnia and Herzegovina,BIH,2022,0,3093,3093,0,0,0,6186
Bosnia and Herzegovina,BIH,2023,0,0,0,3114,0,0,3114
Bosnia and Herzegovina,BIH,1999,0,0,0,0,0,0,0
Bosnia and Herzegovina,BIH,2007,0,0,0,0,0,0,0
Bosnia and Herzegovina,BIH,2012,0,0,0,0,10886,0,10886
Botswana,BWA,1965,0,0,0,0,0,0,0
Botswana,BWA,1968,0,0,0,0,0,0,0
Botswana,BWA,1970,0,0,0,0,0,0,0
Botswana,BWA,1981,0,0,0,0,0,0,0
Botswana,BWA,1990,0,0,0,0,0,0,0
Botswana,BWA,2015,0,0,0,0,0,0,0
Botswana,BWA,2019,0,0,0,0,0,0,0
Botswana,BWA,1972,0,0,0,0,0,0,0
Botswana,BWA,1988,0,63428,0,0,0,0,63428
Botswana,BWA,1995,0,129564,0,0,0,0,129564
Botswana,BWA,2000,0,17371,0,0,0,0,17371
Botswana,BWA,2004,0,0,0,0,0,0,0
Botswana,BWA,2009,0,0,0,0,0,0,0
Botswana,BWA,2011,0,0,0,0,0,0,0
Botswana,BWA,2013,0,54120,0,0,0,0,54120
Botswana,BWA,2017,0,0,0,0,0,0,0
Botswana,BWA,2018,0,0,0,0,0,0,0
Brazil,BRA,1970,0,17848,0,0,0,0,17848
Brazil,BRA,1977,0,5441,0,878,0,0,6319
Brazil,BRA,1978,0,2229,0,0,0,0,2229
Brazil,BRA,1979,0,25116,0,0,0,0,25116
Brazil,BRA,1983,1527,10918,0,0,0,993,13438
Brazil,BRA,1985,0,7384,0,1608,0,0,8992
Brazil,BRA,1987,0,7511,0,0,0,0,7511
Brazil,BRA,1988,0,45093,0,0,5301,0,50394
Brazil,BRA,1994,0,0,0,0,0,0,0
Brazil,BRA,1998,0,760,0,0,0,58,818
Brazil,BRA,2001,0,4770,0,729,0,0,5499
Brazil,BRA,2002,0,942,0,0,0,4821,5763
Brazil,BRA,2004,0,1895,0,217,0,0,2112
Brazil,BRA,2005,0,2516,0,107,0,0,2623
Brazil,BRA,2007,0,3617,52,0,0,0,3669
Brazil,BRA,2010,0,18487,0,0,1630,0,20117
Brazil,BRA,2012,0,150,0,0,0,0,150
Brazil,BRA,2014,0,2015,0,0,0,0,2015
Brazil,BRA,2020,0,7083,0,563,0,0,7646
Brazil,BRA,2021,0,2893,0,0,0,0,2893
Brazil,BRA,2022,0,24522,0,0,0,0,24522
Brazil,BRA,1948,0,39141,0,0,0,0,39141
Brazil,BRA,1957,0,16801,0,0,0,0,16801
Brazil,BRA,1959,0,14108,0,8324,0,0,22432
Brazil,BRA,1964,0,12156,0,0,0,0,12156
Brazil,BRA,1965,0,2600,0,0,0,0,2600
Brazil,BRA,1966,0,64383,0,4139,0,40239,108761
Brazil,BRA,1967,0,91801,0,0,0,48811,140612
Brazil,BRA,1969,0,33617,0,0,0,0,33617
Brazil,BRA,1971,0,24199,0,0,0,0,24199
Brazil,BRA,1973,0,1929,0,0,0,0,1929
Brazil,BRA,1974,0,19309,0,0,0,11397,30706
Brazil,BRA,1975,0,10856,0,0,11591,0,22447
Brazil,BRA,1980,0,5479,0,1227,0,0,6706
Brazil,BRA,1981,0,7750,0,0,0,0,7750
Brazil,BRA,1984,0,19643,0,747,0,0,20390
Brazil,BRA,1986,0,2005,72,0,0,0,2077
Brazil,BRA,1989,0,9257,0,2432,0,8784,20473
Brazil,BRA,1990,0,1593,0,0,0,0,1593
Brazil,BRA,1991,0,1304,0,0,0,1565,2869
Brazil,BRA,1992,0,6863,0,0,0,1924,8787
Brazil,BRA,1995,0,6727,0,0,0,7828,14555
Brazil,BRA,1996,0,903,0,0,0,10299,11202
Brazil,BRA,1997,0,5340,0,178,0,0,5518
Brazil,BRA,1999,0,403,0,0,0,1441,1844
Brazil,BRA,2000,0,2729,0,0,398,3412,6539
Brazil,BRA,2003,0,13963,0,0,0,0,13963
Brazil,BRA,2006,0,1059,0,0,0,0,1059
Brazil,BRA,2008,0,10380,0,156,0,0,10536
Brazil,BRA,2009,0,4627,0,206,0,3804,8637
Brazil,BRA,2011,0,49348,0,0,0,0,49348
Brazil,BRA,2013,0,5899,0,99,0,0,5998
Brazil,BRA,2015,0,536,0,97,0,731,1364
Brazil,BRA,2016,0,1595,0,0,0,0,1595
Brazil,BRA,2017,0,671,0,0,0,0,671
Brazil,BRA,2018,0,333,0,0,0,714,1047
Brazil,BRA,2019,0,2219,0,0,0,0,2219
Brazil,BRA,2023,0,5545,0,0,0,0,5545
Brazil,BRA,1949,0,0,0,19051,0,0,19051
Brazil,BRA,1982,0,0,0,2577,0,0,2577
Brazil,BRA,1968,0,0,0,0,12328,0,12328
Brazil,BRA,1956,0,0,0,0,0,10210,10210
British Virgin Islands,VGB,1996,0,0,0,0,0,0,0
British Virgin Islands,VGB,2017,0,0,0,2991624,0,0,2991624
Brunei,BRN,1998,0,0,0,0,0,0,0
Bulgaria,BGR,1983,0,0,0,0,0,0,0
Bulgaria,BGR,2000,0,0,0,0,8644,8644,17288
Bulgaria,BGR,1997,0,0,0,0,0,0,0
Bulgaria,BGR,2002,0,1254,0,0,0,0,1254
Bulgaria,BGR,2005,0,49903,0,0,23032,0,72935
Bulgaria,BGR,2006,0,0,0,0,0,0,0
Bulgaria,BGR,2007,0,15546,0,0,2591,3886,22023
Bulgaria,BGR,2010,0,0,0,0,3951,0,3951
Bulgaria,BGR,2012,0,6677,0,0,44068,0,50745
Bulgaria,BGR,2014,0,27129,0,1356,0,0,28485
Bulgaria,BGR,2015,0,6841,0,0,0,0,6841
Bulgaria,BGR,2018,0,0,0,0,0,0,0
Bulgaria,BGR,2021,0,0,0,0,0,0,0
Bulgaria,BGR,2022,0,0,0,0,1882938,0,1882938
Bulgaria,BGR,1928,0,0,186082,0,0,0,186082
Bulgaria,BGR,1977,0,0,22383,0,0,0,22383
Bulgaria,BGR,1986,0,0,3374,0,0,0,3374
Bulgaria,BGR,1990,0,0,1141,0,0,0,1141
Bulgaria,BGR,1981,0,0,0,0,0,0,0
Bulgaria,BGR,1993,0,0,0,0,0,0,0
Bulgaria,BGR,1999,0,0,0,0,0,0,0
Bulgaria,BGR,2001,0,0,0,2489,0,0,2489
Bulgaria,BGR,1998,0,0,0,0,3643,0,3643
Bulgaria,BGR,2008,0,0,0,0,13029,0,13029
Bulgaria,BGR,1965,0,0,0,0,0,13341,13341
Burkina Faso,BFA,1910,0,0,0,0,0,0,0
Burkina Faso,BFA,1940,0,0,0,0,0,0,0
Burkina Faso,BFA,1966,0,0,0,0,0,0,0
Burkina Faso,BFA,1969,0,0,0,0,0,0,0
Burkina Faso,BFA,1976,0,0,0,0,0,0,0
Burkina Faso,BFA,1980,0,0,0,0,0,0,0
Burkina Faso,BFA,1988,0,18468,0,0,0,0,18468
Burkina Faso,BFA,1990,0,0,0,0,0,0,0
Burkina Faso,BFA,1995,0,0,0,0,0,0,0
Burkina Faso,BFA,1998,0,0,0,0,0,0,0
Burkina Faso,BFA,2001,0,0,0,0,0,0,0
Burkina Faso,BFA,2011,0,0,0,0,0,0,0
Burkina Faso,BFA,2014,0,0,0,0,0,0,0
Burkina Faso,BFA,2020,0,6040,0,0,0,0,6040
Burkina Faso,BFA,2022,0,0,0,0,0,0,0
Burkina Faso,BFA,1977,0,0,0,0,0,0,0
Burkina Faso,BFA,1984,0,0,0,0,0,0,0
Burkina Faso,BFA,1985,0,0,0,0,0,0,0
Burkina Faso,BFA,1994,0,21801,0,0,0,0,21801
Burkina Faso,BFA,1999,0,5202,0,0,0,0,5202
Burkina Faso,BFA,2003,0,0,0,0,0,0,0
Burkina Faso,BFA,2006,0,0,0,0,0,0,0
Burkina Faso,BFA,2007,0,35237,0,0,0,0,35237
Burkina Faso,BFA,2008,0,3948,0,0,0,0,3948
Burkina Faso,BFA,2009,0,5751,0,0,0,0,5751
Burkina Faso,BFA,2010,0,9927,0,0,0,0,9927
Burkina Faso,BFA,2012,0,10518,0,0,0,0,10518
Burkina Faso,BFA,2013,0,1134,0,0,0,0,1134
Burkina Faso,BFA,2015,0,4274,0,0,0,0,4274
Burkina Faso,BFA,2016,0,7782,0,0,0,0,7782
Burkina Faso,BFA,2017,0,1008,0,0,0,0,1008
Burundi,BDI,1999,9708,0,0,0,0,0,9708
Burundi,BDI,2003,0,0,0,0,0,0,0
Burundi,BDI,2005,162406,0,0,0,0,0,162406
Burundi,BDI,2008,0,10872,0,0,0,0,10872
Burundi,BDI,2009,0,0,0,0,0,0,0
Burundi,BDI,2010,0,0,0,9861,0,0,9861
Burundi,BDI,1989,0,22331,0,0,0,0,22331
Burundi,BDI,2000,0,0,0,0,0,0,0
Burundi,BDI,2002,0,0,0,0,0,0,0
Burundi,BDI,2004,0,0,4213,0,0,0,4213
Burundi,BDI,2006,0,28727,0,0,0,0,28727
Burundi,BDI,2007,0,6294,0,0,0,0,6294
Burundi,BDI,2011,0,0,0,12691,0,0,12691
Burundi,BDI,2014,0,91473,0,0,0,0,91473
Burundi,BDI,2015,0,48475,0,0,0,10254,58729
Burundi,BDI,2018,0,0,0,0,0,0,0
Burundi,BDI,2019,0,20211,0,0,0,31158,51369
Burundi,BDI,2020,0,2455,0,1637,0,0,4092
Burundi,BDI,2021,0,0,0,0,0,0,0
Burundi,BDI,2023,0,10575,0,0,0,0,10575
Burundi,BDI,2017,0,0,0,0,0,5378,5378
Cambodia,KHM,1987,0,0,0,0,0,0,0
Cambodia,KHM,1994,0,475727,0,0,0,0,475727
Cambodia,KHM,2001,0,45388,0,0,0,0,45388
Cambodia,KHM,2002,0,23086,0,0,0,0,23086
Cambodia,KHM,2005,0,12079,0,0,0,0,12079
Cambodia,KHM,2016,0,0,0,0,0,0,0
Cambodia,KHM,1991,0,107999,0,0,0,0,107999
Cambodia,KHM,1996,0,52760,0,0,0,0,52760
Cambodia,KHM,1999,0,5883,0,0,0,0,5883
Cambodia,KHM,2000,0,286331,0,0,0,0,286331
Cambodia,KHM,2004,0,0,0,0,0,0,0
Cambodia,KHM,2006,0,3710,0,0,0,0,3710
Cambodia,KHM,2007,0,1458,0,0,0,0,1458
Cambodia,KHM,2010,0,5570,0,0,0,0,5570
Cambodia,KHM,2011,0,169481,0,0,0,0,169481
Cambodia,KHM,2012,0,9468,0,0,0,0,9468
Cambodia,KHM,2013,0,133336,0,0,0,0,133336
Cambodia,KHM,2014,0,29584,0,0,0,0,29584
Cambodia,KHM,2015,0,0,0,0,0,0,0
Cambodia,KHM,2018,0,0,0,0,0,0,0
Cambodia,KHM,2019,0,7404,0,0,0,0,7404
Cambodia,KHM,2021,0,0,0,603,0,0,603
Cambodia,KHM,2022,0,8946,0,9542,0,0,18488
Cambodia,KHM,1997,0,0,0,21869,0,0,21869
Cambodia,KHM,2009,0,0,0,13422,0,0,13422
Cambodia,KHM,2020,0,0,0,26834,0,0,26834
Cambodia,KHM,2023,0,0,0,0,0,0,0
Cameroon,CMR,1971,0,0,0,0,0,0,0
Cameroon,CMR,1990,0,0,0,0,0,0,0
Cameroon,CMR,2001,0,19363,0,0,0,0,19363
Cameroon,CMR,2005,0,1158,0,0,0,0,1158
Cameroon,CMR,2012,0,11886,0,0,0,0,11886
Cameroon,CMR,2022,0,716,0,0,0,6806,7522
Cameroon,CMR,1988,0,1859,0,0,0,0,1859
Cameroon,CMR,1991,0,1698,0,0,0,0,1698
Cameroon,CMR,1994,0,4670,0,0,0,0,4670
Cameroon,CMR,1999,0,16328,0,0,0,0,16328
Cameroon,CMR,2000,0,1988,0,0,0,0,1988
Cameroon,CMR,2007,0,4383,0,0,0,0,4383
Cameroon,CMR,2008,0,4793,0,0,0,0,4793
Cameroon,CMR,2010,0,6540,0,0,0,0,6540
Cameroon,CMR,2013,0,0,0,0,0,0,0
Cameroon,CMR,2014,0,0,0,0,0,0,0
Cameroon,CMR,2015,0,1738,0,0,0,0,1738
Cameroon,CMR,2017,0,1230,0,0,0,0,1230
Cameroon,CMR,2020,0,0,0,0,0,0,0
Cameroon,CMR,1984,0,0,0,0,0,38912,38912
Cameroon,CMR,1986,0,0,0,0,0,1726540,1726540
Cameroon,CMR,2003,0,0,0,0,0,12229,12229
Cameroon,CMR,2019,0,0,0,0,0,20945,20945
Canada,CAN,1931,0,0,0,0,0,0,0
Canada,CAN,1961,0,0,0,0,0,0,0
Canada,CAN,1977,0,0,0,0,0,0,0
Canada,CAN,1984,0,0,0,0,0,0,0
Canada,CAN,1988,0,746,0,0,0,0,746
Canada,CAN,1950,0,728,0,0,0,0,728
Canada,CAN,1974,0,0,0,0,0,0,0
Canada,CAN,1979,0,0,0,0,0,0,0
Canada,CAN,1983,0,0,0,0,0,0,0
Canada,CAN,1986,0,0,0,0,0,0,0
Canada,CAN,1987,0,378,0,9835,0,0,10213
Canada,CAN,1990,0,2893,0,0,0,0,2893
Canada,CAN,1993,0,0,0,0,0,0,0
Canada,CAN,1995,0,0,0,683,0,0,683
Canada,CAN,1996,0,3379,0,0,0,0,3379
Canada,CAN,1997,0,1339,0,335,0,0,1674
Canada,CAN,1998,0,995,0,9288,0,0,10283
Canada,CAN,2002,0,0,0,0,0,0,0
Canada,CAN,2003,0,1265,0,633,0,316,2214
Canada,CAN,2004,0,0,0,0,0,0,0
Canada,CAN,2005,0,1242,0,0,0,0,1242
Canada,CAN,2006,0,307,0,0,0,0,307
Canada,CAN,2007,0,0,0,1826,0,0,1826
Canada,CAN,2008,0,0,0,0,0,0,0
Canada,CAN,2009,0,0,0,595,0,0,595
Canada,CAN,2011,0,1457,0,583,0,291,2331
Canada,CAN,2012,0,0,0,0,0,0,0
Canada,CAN,2013,0,1141,0,0,2852,0,3993
Canada,CAN,2014,0,0,0,0,0,0,0
Canada,CAN,2016,0,0,0,0,0,0,0
Canada,CAN,2017,0,547,0,0,0,0,547
Canada,CAN,2018,0,0,0,0,18901,0,18901
Canada,CAN,2019,0,267,0,267,0,0,534
Canada,CAN,2020,0,264,0,0,0,0,264
Canada,CAN,2021,0,1048,0,262,213602,524,215436
Canada,CAN,2022,0,0,0,4421,0,0,4421
Canada,CAN,2023,0,1547,0,0,516,516,2579
Canada,CAN,1928,0,0,27328,0,0,0,27328
Canada,CAN,1912,0,0,0,38265,0,0,38265
Canada,CAN,1946,0,0,0,13370,0,0,13370
Canada,CAN,1954,0,0,0,54166,0,0,54166
Canada,CAN,1959,0,0,0,3424,0,0,3424
Canada,CAN,1962,0,0,0,17721,0,0,17721
Canada,CAN,1966,0,0,0,0,0,0,0
Canada,CAN,1970,0,0,0,4665,0,0,4665
Canada,CAN,1971,0,0,0,0,0,14163,14163
Canada,CAN,1975,0,0,0,6051,0,0,6051
Canada,CAN,1981,0,0,0,0,0,0,0
Canada,CAN,1985,0,0,0,4643,0,0,4643
Canada,CAN,1989,0,0,0,0,0,367,367
Canada,CAN,1991,0,0,0,0,0,0,0
Canada,CAN,1994,0,0,0,0,0,0,0
Canada,CAN,1999,0,0,0,2303,0,0,2303
Canada,CAN,2000,0,0,0,3585,0,0,3585
Canada,CAN,2001,0,0,0,3548,0,0,3548
Canada,CAN,2010,0,0,0,0,0,0,0
Canada,CAN,1936,0,0,0,0,457933,0,457933
Canada,CAN,1982,0,0,0,0,0,0,0
Canada,CAN,1992,0,0,0,0,0,0,0
Canada,CAN,1910,0,0,0,0,0,88534,88534
Canada,CAN,1915,0,0,0,0,0,72109,72109
Canada,CAN,1965,0,0,0,0,0,13205,13205
Canada,CAN,1911,0,0,0,0,0,101905,101905
Canada,CAN,1922,0,0,0,0,0,48361,48361
Canada,CAN,1980,0,0,0,0,0,0,0
Canada,CAN,2015,0,0,0,0,0,0,0
Canada,CAN,1903,0,0,0,0,0,130665,130665
Canada,CAN,1905,0,0,0,0,0,29310,29310
Canada,CAN,1908,0,0,0,0,0,49527,49527
Canada,CAN,1955,0,0,0,0,0,1907,1907
Cape Verde,CPV,1900,726734570,0,0,0,0,0,726734570
Cape Verde,CPV,1910,0,0,0,0,0,0,0
Cape Verde,CPV,1920,1518180200,0,0,0,0,0,1518180200
Cape Verde,CPV,1940,920784900,0,0,0,0,0,920784900
Cape Verde,CPV,1946,1532496600,0,0,0,0,0,1532496600
Cape Verde,CPV,1969,0,0,0,0,0,0,0
Cape Verde,CPV,1980,0,0,0,0,0,0,0
Cape Verde,CPV,1992,0,0,0,0,0,0,0
Cape Verde,CPV,1998,0,0,0,0,0,0,0
Cape Verde,CPV,2002,0,0,0,0,0,0,0
Cape Verde,CPV,2017,0,0,0,0,0,0,0
Cape Verde,CPV,2022,0,0,0,0,0,0,0
Cape Verde,CPV,2009,0,58180,0,0,0,0,58180
Cape Verde,CPV,2020,0,17163,0,0,0,0,17163
Cape Verde,CPV,1982,0,0,0,91933,0,0,91933
Cape Verde,CPV,1984,0,0,0,864430,0,0,864430
Cape Verde,CPV,2015,0,0,0,162994,0,0,162994
Cape Verde,CPV,1995,0,0,0,0,0,0,0
Cape Verde,CPV,2014,0,0,0,0,0,0,0
Cayman Islands,CYM,2001,0,0,0,0,0,0,0
Cayman Islands,CYM,2002,0,0,0,0,0,0,0
Cayman Islands,CYM,2004,0,0,0,441394,0,0,441394
Cayman Islands,CYM,2008,0,0,0,0,0,0,0
Central African Republic,CAF,1983,0,0,0,0,0,0,0
Central African Republic,CAF,2022,0,28678,0,0,0,0,28678
Central African Republic,CAF,1973,0,0,0,0,0,0,0
Central African Republic,CAF,1995,0,0,0,0,0,0,0
Central African Republic,CAF,1996,0,20811,0,0,0,0,20811
Central African Republic,CAF,1998,0,0,0,0,0,0,0
Central African Republic,CAF,1999,0,0,0,0,0,0,0
Central African Republic,CAF,2003,0,0,0,0,0,0,0
Central African Republic,CAF,2004,0,7290,0,0,0,0,7290
Central African Republic,CAF,2005,0,2376,0,0,0,0,2376
Central African Republic,CAF,2007,0,2285,0,0,0,0,2285
Central African Republic,CAF,2008,0,0,0,0,0,0,0
Central African Republic,CAF,2009,0,2191,0,6572,0,0,8763
Central African Republic,CAF,2010,0,6438,0,0,0,0,6438
Central African Republic,CAF,2011,0,0,0,2113,0,0,2113
Central African Republic,CAF,2013,0,0,0,0,0,0,0
Central African Republic,CAF,2017,0,0,0,0,0,0,0
Central African Republic,CAF,2019,0,0,0,0,0,0,0
Central African Republic,CAF,2021,0,0,0,0,0,0,0
Central African Republic,CAF,1981,0,0,0,0,0,0,0
Central African Republic,CAF,2001,0,0,0,7803,0,0,7803
Central African Republic,CAF,2012,0,0,0,0,0,0,0
Central African Republic,CAF,2015,0,0,0,2075,0,0,2075
Central African Republic,CAF,2002,0,0,0,0,0,2544,2544
Chad,TCD,1910,0,0,0,0,0,0,0
Chad,TCD,1940,0,0,0,0,0,0,0
Chad,TCD,1966,0,0,0,0,0,0,0
Chad,TCD,1969,0,0,0,0,0,0,0
Chad,TCD,1980,6805439,0,0,0,0,0,6805439
Chad,TCD,1993,0,0,0,0,0,0,0
Chad,TCD,1997,0,0,0,0,0,0,0
Chad,TCD,2001,0,117112,0,0,0,0,117112
Chad,TCD,2009,0,5219,0,0,0,0,5219
Chad,TCD,2012,0,15680,0,0,0,0,15680
Chad,TCD,2017,0,0,0,0,0,0,0
Chad,TCD,2022,0,12413,0,0,0,0,12413
Chad,TCD,1985,0,0,0,0,0,0,0
Chad,TCD,1988,0,78424,0,20062,0,0,98486
Chad,TCD,1991,0,64544,0,0,0,0,64544
Chad,TCD,1995,0,2903,0,0,0,0,2903
Chad,TCD,1998,0,0,0,0,0,0,0
Chad,TCD,1999,0,0,0,0,0,0,0
Chad,TCD,2006,0,50166,0,0,0,0,50166
Chad,TCD,2007,0,13989,0,13056,0,0,27045
Chad,TCD,2008,0,0,0,0,0,0,0
Chad,TCD,2010,0,20177,0,0,0,0,20177
Chad,TCD,2019,0,0,0,0,0,32244,32244
Chad,TCD,2020,0,1802,0,0,0,0,1802
Chad,TCD,2021,0,18627,0,0,0,0,18627
Chad,TCD,1977,0,0,0,30671,0,0,30671
Chile,CHL,1968,0,0,0,0,0,0,0
Chile,CHL,1991,0,0,0,0,0,103967,103967
Chile,CHL,1965,0,667042,444694,64481,0,28905,1205122
Chile,CHL,1974,0,30555,0,0,0,0,30555
Chile,CHL,1978,0,3591,0,0,0,0,3591
Chile,CHL,1982,0,0,0,0,0,0,0
Chile,CHL,1986,0,18379,0,12785,0,0,31164
Chile,CHL,1987,0,99899,3933,0,0,25172,129004
Chile,CHL,1989,0,15996,0,0,0,0,15996
Chile,CHL,1990,0,0,0,0,0,0,0
Chile,CHL,1993,0,77866,0,0,0,4286,82152
Chile,CHL,1995,0,19422,2081,0,1387,0,22890
Chile,CHL,1997,0,14856,5402,2701,0,6753,29712
Chile,CHL,2000,0,10422,0,0,0,0,10422
Chile,CHL,2001,0,2577,0,1288,0,0,3865
Chile,CHL,2002,0,12107,0,0,0,0,12107
Chile,CHL,2004,0,1873,0,0,0,0,1873
Chile,CHL,2005,0,3091,6800,27820,0,0,37711
Chile,CHL,2006,0,11020,0,0,0,0,11020
Chile,CHL,2008,0,5402,0,0,0,0,5402
Chile,CHL,2012,0,0,577,0,0,4036,4613
Chile,CHL,2014,0,0,3392,0,0,6785,10177
Chile,CHL,2015,0,99608,10632,3358,0,560,114158
Chile,CHL,2016,0,6636,0,0,0,0,6636
Chile,CHL,2017,0,4900,0,0,0,17965,22865
Chile,CHL,2019,0,3151,1050,0,0,0,4201
Chile,CHL,2021,0,0,0,0,0,0,0
Chile,CHL,2023,0,3566,0,0,0,13245,16811
Chile,CHL,1906,0,0,58924500,0,0,0,58924500
Chile,CHL,1922,0,0,2409184,0,0,0,2409184
Chile,CHL,1928,0,0,488430,0,0,0,488430
Chile,CHL,1939,0,0,55593040,0,0,0,55593040
Chile,CHL,1943,0,0,20681,0,0,0,20681
Chile,CHL,1946,0,0,3260,0,0,0,3260
Chile,CHL,1949,0,0,63149,0,0,0,63149
Chile,CHL,1953,0,0,21355,0,0,0,21355
Chile,CHL,1958,0,0,0,0,0,0,0
Chile,CHL,1960,0,0,7369354,0,0,0,7369354
Chile,CHL,1966,0,0,4366,0,0,0,4366
Chile,CHL,1971,0,0,85133,0,0,0,85133
Chile,CHL,1983,0,0,3340,0,0,0,3340
Chile,CHL,1985,0,0,146028,0,0,0,146028
Chile,CHL,2007,0,0,7275,0,3637,0,10912
Chile,CHL,2010,0,0,330507,0,0,0,330507
Chile,CHL,1977,0,0,0,13674,0,0,13674
Chile,CHL,1984,0,0,0,104546,0,0,104546
Chile,CHL,1992,0,0,0,0,0,0,0
Chile,CHL,2011,0,0,0,0,0,582,582
Chile,CHL,2013,0,0,0,0,0,0,0
Chile,CHL,1948,0,0,0,0,0,157024,157024
Chile,CHL,1964,0,0,0,0,0,4533,4533
Chile,CHL,1988,0,0,0,0,0,0,0
Chile,CHL,1979,0,0,0,0,0,26538,26538
Chile,CHL,1999,0,0,0,0,0,0,0
Chile,CHL,2003,0,0,0,0,0,0,0
Chile,CHL,2022,0,0,0,0,0,1530,1530
China,CHN,1920,10791432,0,3884916,0,0,0,14676348
China,CHN,1928,62664526,0,0,0,0,0,62664526
China,CHN,1965,0,0,0,0,0,0,0
China,CHN,1978,0,0,0,0,0,0,0
China,CHN,1979,0,0,434,0,0,0,434
China,CHN,1983,0,972,330,4955,0,2691,8948
China,CHN,1985,0,11469,839,2792,0,566,15666
China,CHN,1988,12546,11139,8415,3002,0,466,35568
China,CHN,1991,17085,15897,9,2178,0,1708,36877
China,CHN,1992,0,4562,0,7265,0,414,12241
China,CHN,1994,0,12955,8,12309,861,398,26531
China,CHN,1995,0,13282,583,5590,0,542,19997
China,CHN,1997,0,8806,259,2278,323,1527,13193
China,CHN,1999,0,9439,0,3951,0,366,13756
China,CHN,2000,0,3338,71,1282,0,672,5363
China,CHN,2001,0,3159,63,2703,0,1320,7245
China,CHN,2002,0,9727,16,843,55,492,11133
China,CHN,2003,0,5136,2460,473,0,403,8472
China,CHN,2005,0,4430,123,3265,0,0,7818
China,CHN,2006,1020,3275,175,11423,0,168,16061
China,CHN,2008,0,2646,658293,496,1090,2428,664953
China,CHN,2009,0,1561,7,1262,0,1516,4346
China,CHN,2010,0,14175,22081,1031,0,16014,53301
China,CHN,2013,0,4629,2151,1926,291,1141,10138
China,CHN,2014,0,3415,5328,2375,0,253,11371
China,CHN,2015,0,2224,237,854,0,273,3588
China,CHN,2016,0,5821,21,2425,36,877,9180
China,CHN,2017,0,1638,262,645,0,1099,3644
China,CHN,2021,0,2742,63,386,0,0,3191
China,CHN,2022,0,870,856,168,0,91,1985
China,CHN,1911,0,2365800,0,0,0,0,2365800
China,CHN,1915,0,0,3857,0,0,0,3857
China,CHN,1917,0,0,39967,0,0,0,39967
China,CHN,1931,0,76251570,206085,0,0,0,76457655
China,CHN,1933,0,366767,207835,0,0,0,574602
China,CHN,1935,0,2859386,2014,0,0,0,2861400
China,CHN,1939,0,9834328,0,0,0,0,9834328
China,CHN,1948,0,6186,17057,33739,0,0,56982
China,CHN,1949,0,1059645,390,0,0,0,1060035
China,CHN,1950,0,9192,0,0,0,0,9192
China,CHN,1951,0,86703,0,0,0,0,86703
China,CHN,1954,0,542432,0,0,0,0,542432
China,CHN,1956,0,32453,0,32453,0,0,64906
China,CHN,1957,0,8889,0,0,0,0,8889
China,CHN,1959,0,30669284,0,27354,0,0,30696638
China,CHN,1969,0,0,37433,0,0,0,37433
China,CHN,1975,0,218549,21855,0,0,0,240404
China,CHN,1980,0,64161,0,1914,0,0,66075
China,CHN,1981,0,23214,1504,0,0,0,24718
China,CHN,1982,0,4411,99,0,0,927,5437
China,CHN,1984,0,297,0,125,0,958,1380
China,CHN,1986,0,2904,0,3414,19,0,6337
China,CHN,1987,0,1997,0,3702,0,2334,8033
China,CHN,1989,0,17630,370,9829,0,35,27864
China,CHN,1990,0,4291,1101,5452,0,633,11477
China,CHN,1993,0,10294,0,1790,0,1003,13087
China,CHN,1996,0,33306,2874,5186,0,4323,45689
China,CHN,1998,0,34086,441,770,0,802,36099
China,CHN,2004,0,3470,31,1920,301,501,6223
China,CHN,2007,0,7711,23,719,0,250,8703
China,CHN,2011,0,4628,236,324,15,295,5498
China,CHN,2012,0,4552,629,549,0,139,5869
China,CHN,2018,0,1722,0,776,0,0,2498
China,CHN,2019,0,2497,113,570,0,837,4017
China,CHN,2020,0,2877,28,182,0,161,3248
China,CHN,2023,0,870,0,428,0,245,1543
China,CHN,1902,0,0,62484,0,0,0,62484
China,CHN,1905,0,0,0,0,0,0,0
China,CHN,1906,0,0,6849,0,0,0,6849
China,CHN,1907,0,0,291965,0,0,0,291965
China,CHN,1909,0,0,505,0,0,0,505
China,CHN,1913,0,0,21835,0,0,0,21835
China,CHN,1918,0,0,219618,0,0,0,219618
China,CHN,1923,0,0,106305,0,0,0,106305
China,CHN,1924,0,0,2119,0,0,0,2119
China,CHN,1925,0,0,105809,0,0,0,105809
China,CHN,1927,0,0,857606,104811,0,0,962417
China,CHN,1930,0,0,5012,0,0,0,5012
China,CHN,1936,0,0,2903,0,0,0,2903
China,CHN,1937,0,0,7761,0,0,0,7761
China,CHN,1940,0,0,3540,0,0,0,3540
China,CHN,1941,0,0,2859,0,0,0,2859
China,CHN,1942,0,0,2321,0,0,0,2321
China,CHN,1945,0,0,324,0,0,0,324
China,CHN,1952,0,0,956,0,0,0,956
China,CHN,1955,0,0,646,0,0,0,646
China,CHN,1967,0,0,0,0,0,0,0
China,CHN,1970,0,0,121575,1301,0,0,122876
China,CHN,1973,0,0,0,0,0,0,0
China,CHN,1974,0,0,222378,0,0,0,222378
China,CHN,1976,0,0,2603898,0,0,0,2603898
China,CHN,1912,0,0,0,1171486,0,0,1171486
China,CHN,1922,0,0,0,2133638,0,0,2133638
China,CHN,1964,0,0,0,9736,0,0,9736
China,CHN,1934,0,0,0,0,0,10128,10128
Colombia,COL,1998,0,0,0,0,0,27409,27409
Colombia,COL,2015,0,0,0,0,0,22071,22071
Colombia,COL,1959,0,120964,0,0,0,0,120964
Colombia,COL,1962,0,80881,28158,0,0,0,109039
Colombia,COL,1969,0,0,0,0,0,0,0
Colombia,COL,1970,0,194688,0,0,0,0,194688
Colombia,COL,1971,0,23826,0,0,0,93434,117260
Colombia,COL,1973,0,4019,0,0,0,96444,100463
Colombia,COL,1976,0,19655,0,0,0,5436,25091
Colombia,COL,1979,0,24238,249811,0,0,0,274049
Colombia,COL,1980,0,15281,0,0,0,0,15281
Colombia,COL,1981,0,55999,3733,0,0,24266,83998
Colombia,COL,1982,0,32840,0,0,0,10947,43787
Colombia,COL,1984,0,0,0,0,0,0,0
Colombia,COL,1986,0,4339,0,1335,0,87116,92790
Colombia,COL,1987,0,6862,0,0,0,213377,220239
Colombia,COL,1988,0,38392,0,8318,0,0,46710
Colombia,COL,1989,0,5012,0,0,0,0,5012
Colombia,COL,1990,0,3067,0,0,0,0,3067
Colombia,COL,1993,0,18200,578,0,0,30334,49112
Colombia,COL,1994,0,10483,76780,0,0,0,87263
Colombia,COL,1995,0,19183,15290,0,0,4726,39199
Colombia,COL,1996,0,3276,0,0,0,1365,4641
Colombia,COL,1997,0,536,0,0,0,0,536
Colombia,COL,1999,0,10626,307373,518,0,12181,330698
Colombia,COL,2000,0,28815,510,0,0,0,29325
Colombia,COL,2001,0,0,0,1255,0,23596,24851
Colombia,COL,2002,0,16068,0,0,0,17304,33372
Colombia,COL,2003,0,19485,0,0,0,8525,28010
Colombia,COL,2004,0,27612,240,0,0,0,27852
Colombia,COL,2005,0,42633,0,0,0,0,42633
Colombia,COL,2006,0,35069,0,0,0,0,35069
Colombia,COL,2007,0,50339,0,0,0,0,50339
Colombia,COL,2008,0,19856,2511,0,0,12553,34920
Colombia,COL,2009,0,5190,0,0,0,6770,11960
Colombia,COL,2010,0,93270,0,0,0,45966,139236
Colombia,COL,2011,0,60253,0,0,0,8828,69081
Colombia,COL,2012,0,16819,0,0,0,0,16819
Colombia,COL,2013,0,1514,0,0,0,0,1514
Colombia,COL,2014,0,16496,0,2357,0,0,18853
Colombia,COL,2016,0,2100,0,0,0,0,2100
Colombia,COL,2017,0,7239,0,0,0,72180,79419
Colombia,COL,2018,0,5276,0,0,0,0,5276
Colombia,COL,2019,0,10361,0,0,0,6376,16737
Colombia,COL,2020,0,4909,0,4516,0,3534,12959
Colombia,COL,2021,0,4270,0,0,0,3882,8152
Colombia,COL,2022,0,15615,0,0,0,14458,30073
Colombia,COL,2023,0,576,0,0,0,5568,6144
Colombia,COL,1906,0,0,879357,0,0,0,879357
Colombia,COL,1923,0,0,444608,0,0,0,444608
Colombia,COL,1936,0,0,20617,0,0,0,20617
Colombia,COL,1950,0,0,179273,0,0,0,179273
Colombia,COL,1958,0,0,75199,0,0,0,75199
Colombia,COL,1967,0,0,41874,0,0,0,41874
Colombia,COL,1974,0,0,4804,0,0,170321,175125
Colombia,COL,1983,0,0,89151,357,0,57057,146565
Colombia,COL,1991,0,0,601,0,0,31557,32158
Colombia,COL,1992,0,0,3241,0,0,0,3241
Colombia,COL,1968,0,0,0,0,0,0,0
Colombia,COL,1949,0,0,0,0,0,872842,872842
Colombia,COL,1985,0,0,0,0,0,7433612,7433612
Colombia,COL,1926,0,0,0,0,0,137825,137825
Colombia,COL,1954,0,0,0,0,0,142415,142415
Colombia,COL,1965,0,0,0,0,0,17509,17509
Colombia,COL,1972,0,0,0,0,0,31966,31966
Colombia,COL,1977,0,0,0,0,0,0,0
Comoros,COM,1981,0,0,0,0,0,0,0
Comoros,COM,2009,0,31129,0,0,0,0,31129
Comoros,COM,2012,0,58431,0,0,0,0,58431
Comoros,COM,2014,0,0,0,0,0,0,0
Comoros,COM,1951,0,0,0,30274408,0,0,30274408
Comoros,COM,1983,0,0,0,926571,0,0,926571
Comoros,COM,1985,0,0,0,53239,0,0,53239
Comoros,COM,1987,0,0,0,604694,0,0,604694
Comoros,COM,1989,0,0,0,0,0,0,0
Comoros,COM,2003,0,0,0,0,0,0,0
Comoros,COM,2019,0,0,0,101139,0,0,101139
Comoros,COM,1903,0,0,0,0,0,1874993,1874993
Comoros,COM,1977,0,0,0,0,0,33538,33538
Comoros,COM,1991,0,0,0,0,0,0,0
Comoros,COM,2005,0,0,0,0,0,16872,16872
Comoros,COM,2006,0,0,0,0,0,0,0
Congo [Republic],COG,1983,0,0,0,0,0,0,0
Congo [Republic],COG,1994,0,0,0,0,0,0,0
Congo [Republic],COG,1998,0,0,0,0,0,0,0
Congo [Republic],COG,1999,0,6630,0,0,0,0,6630
Congo [Republic],COG,2002,0,0,0,0,0,0,0
Congo [Republic],COG,2005,0,2723,0,0,0,0,2723
Congo [Republic],COG,2006,0,15734,0,0,0,0,15734
Congo [Republic],COG,2007,0,0,0,0,0,0,0
Congo [Republic],COG,2012,0,40312,0,0,0,0,40312
Congo [Republic],COG,2019,0,0,0,0,0,0,0
Congo [Republic],COG,2020,0,35074,0,0,0,0,35074
Congo [Republic],COG,2021,0,41125,0,0,0,0,41125
Congo [Republic],COG,2022,0,0,0,0,0,0,0
Congo [Republic],COG,1967,0,0,0,0,0,1204703,1204703
Cook Islands,COK,1967,0,0,0,0,0,0,0
Cook Islands,COK,1981,0,0,0,0,0,0,0
Cook Islands,COK,1987,0,0,0,3016227,0,0,3016227
Cook Islands,COK,1990,0,0,0,583192,0,0,583192
Cook Islands,COK,1997,0,0,0,10791776,0,0,10791776
Cook Islands,COK,2001,0,0,0,0,0,0,0
Cook Islands,COK,2005,0,0,0,0,0,0,0
Cook Islands,COK,2010,0,0,0,0,0,0,0
Costa Rica,CRI,1973,0,0,104673,0,0,0,104673
Costa Rica,CRI,1994,0,5732,0,0,0,0,5732
Costa Rica,CRI,1998,0,0,0,20935,0,0,20935
Costa Rica,CRI,2014,0,0,0,0,0,0,0
Costa Rica,CRI,2018,0,1984,0,0,0,0,1984
Costa Rica,CRI,1969,0,38760,0,0,0,0,38760
Costa Rica,CRI,1970,0,129331,0,0,0,0,129331
Costa Rica,CRI,1980,0,4142,0,0,0,0,4142
Costa Rica,CRI,1988,0,23322,0,93288,0,0,116610
Costa Rica,CRI,1991,0,3087,145088,0,0,0,148175
Costa Rica,CRI,1993,0,26429,8810,0,0,0,35239
Costa Rica,CRI,1996,0,16410,0,147693,0,0,164103
Costa Rica,CRI,1999,0,23068,0,0,0,0,23068
Costa Rica,CRI,2001,0,0,0,0,0,0,0
Costa Rica,CRI,2002,0,24256,0,0,0,0,24256
Costa Rica,CRI,2003,0,2387,4775,0,0,0,7162
Costa Rica,CRI,2004,0,4703,18811,0,0,0,23514
Costa Rica,CRI,2005,0,11585,0,2317,0,0,13902
Costa Rica,CRI,2007,0,42793,0,0,0,0,42793
Costa Rica,CRI,2008,0,15549,0,8885,0,0,24434
Costa Rica,CRI,2010,0,58413,0,0,0,0,58413
Costa Rica,CRI,2011,0,8547,0,0,0,0,8547
Costa Rica,CRI,2012,0,12667,4222,0,0,0,16889
Costa Rica,CRI,2015,0,0,0,0,0,0,0
Costa Rica,CRI,2021,0,5821,0,0,0,0,5821
Costa Rica,CRI,1910,0,0,62605890,0,0,0,62605890
Costa Rica,CRI,1952,0,0,286291,0,0,0,286291
Costa Rica,CRI,1955,0,0,88969,0,0,0,88969
Costa Rica,CRI,1983,0,0,45757,0,0,0,45757
Costa Rica,CRI,1990,0,0,3166,0,0,0,3166
Costa Rica,CRI,2009,0,0,67936,0,0,0,67936
Costa Rica,CRI,1995,0,0,0,0,0,0,0
Costa Rica,CRI,2016,0,0,0,18199,0,0,18199
Costa Rica,CRI,2017,0,0,0,26032,0,0,26032
Costa Rica,CRI,2020,0,0,0,0,0,0,0
Costa Rica,CRI,2022,0,0,0,0,0,0,0
Costa Rica,CRI,1963,0,0,0,0,0,100090,100090
Costa Rica,CRI,1968,0,0,0,0,0,495349,495349
Costa Rica,CRI,1975,0,0,0,0,0,9470,9470
Costa Rica,CRI,1976,0,0,0,0,0,0,0
Costa Rica,CRI,2000,0,0,0,0,0,17592,17592
Costa Rica,CRI,1992,0,0,0,0,0,0,0
Côte d'Ivoire,CIV,1980,0,0,0,0,0,0,0
Côte d'Ivoire,CIV,1989,0,0,0,0,0,0,0
Côte d'Ivoire,CIV,1996,0,18905,0,0,0,0,18905
Côte d'Ivoire,CIV,2007,0,0,0,0,0,0,0
Côte d'Ivoire,CIV,2008,0,2964,0,0,0,0,2964
Côte d'Ivoire,CIV,2010,0,8523,0,0,0,0,8523
Côte d'Ivoire,CIV,2014,0,20004,0,0,0,0,20004
Côte d'Ivoire,CIV,2015,0,6781,0,0,0,0,6781
Côte d'Ivoire,CIV,2016,0,8260,0,0,0,0,8260
Côte d'Ivoire,CIV,2017,0,6037,0,0,0,0,6037
Côte d'Ivoire,CIV,2018,0,7845,0,0,0,0,7845
Côte d'Ivoire,CIV,2019,0,4589,0,0,0,0,4589
Côte d'Ivoire,CIV,2020,0,8951,0,0,0,0,8951
Côte d'Ivoire,CIV,2022,0,4616,0,0,0,0,4616
Côte d'Ivoire,CIV,2009,0,0,0,0,0,13058,13058
Croatia,HRV,2003,0,0,0,0,1766364,0,1766364
Croatia,HRV,2000,0,0,0,0,87942,2199,90141
Croatia,HRV,2001,0,0,0,0,0,0,0
Croatia,HRV,2005,0,0,0,4515,11287,0,15802
Croatia,HRV,2006,0,0,0,0,0,0,0
Croatia,HRV,2010,0,0,0,0,0,0,0
Croatia,HRV,2012,0,0,0,0,16160,0,16160
Croatia,HRV,2014,0,7003,0,0,0,0,7003
Croatia,HRV,2015,0,0,0,0,0,0,0
Croatia,HRV,2018,0,0,0,0,0,0,0
Croatia,HRV,2019,0,2421,0,0,0,0,2421
Croatia,HRV,2022,0,0,0,0,1813733,0,1813733
Croatia,HRV,2023,0,0,0,2495,0,0,2495
Croatia,HRV,1996,0,0,0,0,0,0,0
Croatia,HRV,2020,0,0,21968,0,0,0,21968
Croatia,HRV,2017,0,0,0,0,0,0,0
Croatia,HRV,1997,0,0,0,0,0,0,0
Croatia,HRV,2007,0,0,0,0,0,27238,27238
Cuba,CUB,1981,0,0,0,0,0,0,0
Cuba,CUB,1986,0,0,0,0,0,0,0
Cuba,CUB,1993,0,42432,0,4612,0,0,47044
Cuba,CUB,1998,0,0,0,5438,0,0,5438
Cuba,CUB,2000,0,1801,0,0,0,0,1801
Cuba,CUB,2004,0,0,0,3563,0,0,3563
Cuba,CUB,2015,0,2646,0,0,0,0,2646
Cuba,CUB,1977,0,7237,0,0,0,0,7237
Cuba,CUB,1983,0,15023,0,0,0,0,15023
Cuba,CUB,1985,0,0,0,3941,0,0,3941
Cuba,CUB,1988,0,22061,0,0,0,0,22061
Cuba,CUB,1990,0,3764,0,0,0,0,3764
Cuba,CUB,1992,0,0,0,0,0,0,0
Cuba,CUB,1994,0,11022,0,1837,0,0,12859
Cuba,CUB,1995,0,0,0,1830,0,0,1830
Cuba,CUB,1996,0,2736,0,0,0,0,2736
Cuba,CUB,1997,0,0,0,0,0,0,0
Cuba,CUB,2002,0,0,0,2686,0,0,2686
Cuba,CUB,2003,0,0,0,0,0,0,0
Cuba,CUB,2006,0,1776,0,0,0,0,1776
Cuba,CUB,2007,0,0,0,887,0,0,887
Cuba,CUB,2008,0,0,0,6208,0,0,6208
Cuba,CUB,2012,0,1768,0,10611,0,0,12379
Cuba,CUB,2013,0,1767,0,0,0,0,1767
Cuba,CUB,2022,0,2676,0,5351,0,0,8027
Cuba,CUB,2023,0,5360,0,0,0,0,5360
Cuba,CUB,1976,0,0,1042,0,0,0,1042
Cuba,CUB,1926,0,0,0,1680360,0,0,1680360
Cuba,CUB,1932,0,0,0,6127649,0,0,6127649
Cuba,CUB,1935,0,0,0,81425,0,0,81425
Cuba,CUB,1944,0,0,0,0,0,0,0
Cuba,CUB,1948,0,0,0,24702,0,0,24702
Cuba,CUB,1963,0,0,0,2262047,0,0,2262047
Cuba,CUB,1964,0,0,0,0,0,0,0
Cuba,CUB,1966,0,0,0,6075,0,0,6075
Cuba,CUB,1968,0,0,0,0,0,0,0
Cuba,CUB,1970,0,0,0,22549,0,0,22549
Cuba,CUB,1978,0,0,0,6167,0,0,6167
Cuba,CUB,1980,0,0,0,3058,0,0,3058
Cuba,CUB,1982,0,0,0,24221,0,0,24221
Cuba,CUB,1999,0,0,0,3613,0,0,3613
Cuba,CUB,2001,0,0,0,4489,0,0,4489
Cuba,CUB,2005,0,0,0,17784,0,0,17784
Cuba,CUB,2016,0,0,0,0,0,0,0
Cuba,CUB,2017,0,0,0,8821,0,0,8821
Cuba,CUB,2018,0,0,0,7945,0,0,7945
Cuba,CUB,2019,0,0,0,5302,0,0,5302
Cuba,CUB,2020,0,0,0,0,0,0,0
Cuba,CUB,2021,0,0,0,0,0,0,0
Cuba,CUB,1987,0,0,0,0,0,0,0
Cyprus,CYP,1991,0,0,0,0,0,0,0
Cyprus,CYP,2000,0,0,0,0,52729,0,52729
Cyprus,CYP,1953,0,0,773655,0,0,0,773655
Cyprus,CYP,1995,0,0,23191,0,0,0,23191
Cyprus,CYP,1969,0,0,0,47108,0,0,47108
Cyprus,CYP,1983,0,0,0,0,0,0,0
Cyprus,CYP,2003,0,0,0,0,0,0,0
Cyprus,CYP,2004,0,0,0,0,0,0,0
Cyprus,CYP,1998,0,0,0,0,568513,0,568513
Cyprus,CYP,2007,0,0,0,0,37248,0,37248
Cyprus,CYP,2022,0,0,0,0,807037,0,807037
Cyprus,CYP,2021,0,0,0,0,0,32149,32149
Czech Republic,CZE,1996,0,971,0,0,0,0,971
Czech Republic,CZE,1997,0,28213,0,0,0,0,28213
Czech Republic,CZE,1998,0,5846,0,0,0,0,5846
Czech Republic,CZE,2000,0,0,0,0,0,0,0
Czech Republic,CZE,2002,0,17581,0,1953,0,0,19534
Czech Republic,CZE,2005,0,973,0,0,14591,0,15564
Czech Republic,CZE,2006,0,5823,0,0,0,0,5823
Czech Republic,CZE,2009,0,12474,0,1919,0,0,14393
Czech Republic,CZE,2010,0,10511,0,0,11467,0,21978
Czech Republic,CZE,2013,0,14266,0,0,0,0,14266
Czech Republic,CZE,2021,0,0,0,5708,0,0,5708
Czech Republic,CZE,2023,0,0,0,0,0,0,0
Czech Republic,CZE,2007,0,0,0,3869,0,0,3869
Czech Republic,CZE,2008,0,0,0,1927,0,0,1927
Czech Republic,CZE,2017,0,0,0,0,0,0,0
Czech Republic,CZE,2020,0,0,0,950,0,0,950
Czech Republic,CZE,2022,0,0,0,953,265866,0,266819
Czech Republic,CZE,2003,0,0,0,0,407883,0,407883
Czech Republic,CZE,2012,0,0,0,0,30444,0,30444
Czech Republic,CZE,2018,0,0,0,0,2848,0,2848
Congo [DRC],COD,1978,0,0,0,0,0,0,0
Congo [DRC],COD,1983,0,0,0,0,0,0,0
Congo [DRC],COD,2022,0,22523,0,0,0,0,22523
Congo [DRC],COD,1990,0,6391,0,0,0,0,6391
Congo [DRC],COD,1994,0,9395,0,0,0,0,9395
Congo [DRC],COD,1997,0,0,0,0,0,0,0
Congo [DRC],COD,1999,0,423,0,0,0,0,423
Congo [DRC],COD,2001,0,9979,0,0,0,2395,12374
Congo [DRC],COD,2002,0,7743,0,0,0,38713,46456
Congo [DRC],COD,2003,0,188,0,5263,0,0,5451
Congo [DRC],COD,2006,0,171,0,514,0,0,685
Congo [DRC],COD,2007,0,5308,0,0,0,0,5308
Congo [DRC],COD,2008,0,2410,1767,1606,0,0,5783
Congo [DRC],COD,2009,0,0,0,0,0,0,0
Congo [DRC],COD,2010,0,0,0,0,0,8134,8134
Congo [DRC],COD,2011,0,0,0,0,0,0,0
Congo [DRC],COD,2012,0,141,0,0,0,0,141
Congo [DRC],COD,2014,0,20254,0,0,0,1447,21701
Congo [DRC],COD,2015,0,6230,381,0,0,381,6992
Congo [DRC],COD,2016,0,6140,0,0,0,0,6140
Congo [DRC],COD,2017,0,12458,0,0,0,20645,33103
Congo [DRC],COD,2018,0,5856,0,0,0,0,5856
Congo [DRC],COD,2019,0,4783,0,0,0,4115,8898
Congo [DRC],COD,2020,0,8939,0,0,0,0,8939
Congo [DRC],COD,2023,0,290428,0,0,0,1858,292286
Congo [DRC],COD,1966,0,0,13377,0,0,0,13377
Congo [DRC],COD,1992,0,0,2348,0,0,0,2348
Congo [DRC],COD,2005,0,0,1061,1415,0,0,2476
Congo [DRC],COD,1977,0,0,0,0,0,60602,60602
Congo [DRC],COD,2021,0,0,0,0,0,3337,3337
Congo [DRC],COD,1968,0,0,0,0,0,80955,80955
Congo [DRC],COD,1989,0,0,0,0,0,0,0
Denmark,DNK,1992,0,0,0,0,0,0,0
Denmark,DNK,1976,0,0,0,0,0,0,0
Denmark,DNK,1980,0,0,0,0,0,0,0
Denmark,DNK,1981,0,0,0,17554,0,0,17554
Denmark,DNK,1983,0,0,0,3903,0,0,3903
Denmark,DNK,1985,0,0,0,0,0,0,0
Denmark,DNK,1990,0,0,0,1944,0,0,1944
Denmark,DNK,1999,0,0,0,13158,0,0,13158
Denmark,DNK,2002,0,0,0,1859,0,0,1859
Denmark,DNK,2005,0,0,0,7358,0,0,7358
Denmark,DNK,2007,0,0,0,0,0,0,0
Denmark,DNK,2010,0,0,0,0,0,0,0
Denmark,DNK,2013,0,0,0,3555,0,0,3555
Denmark,DNK,2022,0,0,0,1700,428407,0,430107
Djibouti,DJI,1980,0,0,0,0,0,0,0
Djibouti,DJI,1983,0,0,0,0,0,0,0
Djibouti,DJI,1988,0,0,0,0,0,0,0
Djibouti,DJI,1996,0,0,0,0,0,0,0
Djibouti,DJI,1999,0,0,0,0,0,0,0
Djibouti,DJI,2005,0,0,0,0,0,0,0
Djibouti,DJI,2007,0,0,0,0,0,0,0
Djibouti,DJI,2008,0,0,0,0,0,0,0
Djibouti,DJI,2010,0,0,0,0,0,0,0
Djibouti,DJI,2022,0,0,0,0,0,0,0
Djibouti,DJI,1977,0,0,0,0,0,0,0
Djibouti,DJI,1978,0,0,0,0,0,0,0
Djibouti,DJI,1981,0,732440,0,0,0,0,732440
Djibouti,DJI,1989,0,191897,0,0,0,0,191897
Djibouti,DJI,1993,0,0,0,0,0,0,0
Djibouti,DJI,1994,0,2325649,0,0,0,0,2325649
Djibouti,DJI,2004,0,623182,0,0,0,0,623182
Djibouti,DJI,2019,0,102421,0,0,0,0,102421
Djibouti,DJI,2020,0,73384,0,0,0,0,73384
Djibouti,DJI,1995,0,0,0,0,0,0,0
Djibouti,DJI,2018,0,0,0,18918,0,0,18918
Dominica,DMA,2004,0,0,0,0,0,0,0
Dominica,DMA,1930,0,0,0,480272800,0,0,480272800
Dominica,DMA,1963,0,0,0,0,0,0,0
Dominica,DMA,1970,0,0,0,0,0,0,0
Dominica,DMA,1979,0,0,0,5495411,0,0,5495411
Dominica,DMA,1980,0,0,0,0,0,0,0
Dominica,DMA,1984,0,0,0,277944,0,0,277944
Dominica,DMA,1989,0,0,0,0,0,0,0
Dominica,DMA,1995,0,0,0,288917,0,0,288917
Dominica,DMA,1999,0,0,0,0,0,0,0
Dominica,DMA,2007,0,0,0,290744,0,0,290744
Dominica,DMA,2011,0,0,0,0,0,0,0
Dominica,DMA,2015,0,0,0,4284062,0,0,4284062
Dominica,DMA,2017,0,0,0,9088069,0,0,9088069
Dominican Republic,DOM,1968,0,0,0,0,0,0,0
Dominican Republic,DOM,1979,0,56880,0,2488503,0,0,2545383
Dominican Republic,DOM,1981,0,33983,0,0,0,0,33983
Dominican Republic,DOM,1985,0,18698,0,0,0,0,18698
Dominican Republic,DOM,1988,0,0,0,0,0,0,0
Dominican Republic,DOM,1991,0,13739,0,0,0,0,13739
Dominican Republic,DOM,1993,0,39598,0,0,0,0,39598
Dominican Republic,DOM,1996,0,3744,0,29954,0,0,33698
Dominican Republic,DOM,2002,0,3411,0,0,0,0,3411
Dominican Republic,DOM,2003,0,11211,3363,8969,0,0,23543
Dominican Republic,DOM,2004,0,760798,0,16587,0,0,777385
Dominican Republic,DOM,2005,0,3273,0,9820,0,0,13093
Dominican Republic,DOM,2007,0,12763,0,173364,0,0,186127
Dominican Republic,DOM,2009,0,7255,0,0,0,0,7255
Dominican Republic,DOM,2010,0,7161,0,0,0,0,7161
Dominican Republic,DOM,2011,0,4039,0,7068,0,0,11107
Dominican Republic,DOM,2012,0,0,0,7975,0,0,7975
Dominican Republic,DOM,2013,0,0,0,0,0,0,0
Dominican Republic,DOM,2014,0,973,0,0,0,0,973
Dominican Republic,DOM,2015,0,1922,0,0,0,0,1922
Dominican Republic,DOM,2016,0,14248,0,5699,0,0,19947
Dominican Republic,DOM,2018,0,0,0,0,0,0,0
Dominican Republic,DOM,2022,0,0,0,1781,0,0,1781
Dominican Republic,DOM,2023,0,882,0,2647,0,0,3529
Dominican Republic,DOM,1946,0,0,350699,0,0,0,350699
Dominican Republic,DOM,1930,0,0,0,15775757,0,0,15775757
Dominican Republic,DOM,1963,0,0,0,1100168,0,0,1100168
Dominican Republic,DOM,1964,0,0,0,18655,0,0,18655
Dominican Republic,DOM,1966,0,0,0,185599,0,0,185599
Dominican Republic,DOM,1980,0,0,0,12162,0,0,12162
Dominican Republic,DOM,1986,0,0,0,18309,0,0,18309
Dominican Republic,DOM,1987,0,0,0,4482,0,0,4482
Dominican Republic,DOM,1989,0,0,0,0,0,0,0
Dominican Republic,DOM,1995,0,0,0,13978,0,0,13978
Dominican Republic,DOM,1998,0,0,0,418975,0,0,418975
Dominican Republic,DOM,2001,0,0,0,3461,0,0,3461
Dominican Republic,DOM,2008,0,0,0,13651,0,0,13651
Dominican Republic,DOM,2017,0,0,0,4696,0,0,4696
Dominican Republic,DOM,2020,0,0,0,5455,0,0,5455
Dominican Republic,DOM,2021,0,0,0,1799,0,0,1799
Dominican Republic,DOM,1965,0,0,0,0,0,0,0
Dominican Republic,DOM,1983,0,0,0,0,0,0,0
Ecuador,ECU,1964,0,0,0,0,0,0,0
Ecuador,ECU,1997,0,204374,0,0,0,0,204374
Ecuador,ECU,2009,0,2035,0,0,0,0,2035
Ecuador,ECU,2013,0,0,0,0,0,15264,15264
Ecuador,ECU,1950,0,142097,0,0,0,0,142097
Ecuador,ECU,1953,0,186292,0,0,0,0,186292
Ecuador,ECU,1965,0,0,0,0,0,0,0
Ecuador,ECU,1967,0,0,0,0,0,0,0
Ecuador,ECU,1970,0,32403,46985,0,0,0,79388
Ecuador,ECU,1971,0,0,0,0,0,31491,31491
Ecuador,ECU,1973,0,0,0,0,0,37200,37200
Ecuador,ECU,1982,0,358117,0,0,0,0,358117
Ecuador,ECU,1983,0,0,0,0,0,113690,113690
Ecuador,ECU,1987,0,0,5141129,0,0,102781,5243910
Ecuador,ECU,1989,0,34279,0,0,0,0,34279
Ecuador,ECU,1992,0,20157,0,0,0,0,20157
Ecuador,ECU,2000,0,26927,0,0,0,34847,61774
Ecuador,ECU,2001,0,45152,0,0,0,0,45152
Ecuador,ECU,2002,0,23717,0,0,0,45904,69621
Ecuador,ECU,2003,0,0,0,0,0,0,0
Ecuador,ECU,2006,0,11421,0,0,0,3569,14990
Ecuador,ECU,2008,0,28282,0,0,0,0,28282
Ecuador,ECU,2010,0,9340,0,0,0,0,9340
Ecuador,ECU,2011,0,0,0,0,0,4594,4594
Ecuador,ECU,2012,0,18729,0,0,0,3229,21958
Ecuador,ECU,2015,0,7409,0,0,0,0,7409
Ecuador,ECU,2016,0,5475,409378,0,0,0,414853
Ecuador,ECU,2019,0,8072,0,0,0,1153,9225
Ecuador,ECU,2020,0,0,0,0,0,0,0
Ecuador,ECU,2021,0,3371,0,0,0,0,3371
Ecuador,ECU,2022,0,42220,556,0,0,0,42776
Ecuador,ECU,2023,0,16492,7696,0,0,48377,72565
Ecuador,ECU,1924,0,0,206706,0,0,0,206706
Ecuador,ECU,1942,0,0,727779,0,0,0,727779
Ecuador,ECU,1949,0,0,17561693,0,0,0,17561693
Ecuador,ECU,1976,0,0,27381,0,0,83512,110893
Ecuador,ECU,1980,0,0,9833,0,0,0,9833
Ecuador,ECU,1990,0,0,3828,0,0,0,3828
Ecuador,ECU,1995,0,0,2595,0,0,0,2595
Ecuador,ECU,1996,0,0,22930,0,0,0,22930
Ecuador,ECU,1998,0,0,2459,0,0,0,2459
Ecuador,ECU,2014,0,0,1880,0,0,0,1880
Ecuador,ECU,1975,0,0,0,0,0,0,0
Ecuador,ECU,1999,0,0,0,0,0,0,0
Ecuador,ECU,1931,0,0,0,0,0,909287,909287
Ecuador,ECU,1966,0,0,0,0,0,90979,90979
Ecuador,ECU,1993,0,0,0,0,0,413192,413192
Ecuador,ECU,1985,0,0,0,0,0,0,0
Ecuador,ECU,1994,0,0,0,0,0,0,0
Egypt,EGY,1954,0,0,0,0,0,0,0
Egypt,EGY,1975,0,3868,0,0,0,0,3868
Egypt,EGY,1979,0,11728,0,704,0,0,12432
Egypt,EGY,1991,0,171,0,0,0,0,171
Egypt,EGY,1994,0,95578,0,0,0,0,95578
Egypt,EGY,1995,0,1091,1558,0,4987,0,7636
Egypt,EGY,1996,0,1830,0,0,3355,0,5185
Egypt,EGY,1997,0,597,0,2687,0,0,3284
Egypt,EGY,2002,0,2420,0,0,0,0,2420
Egypt,EGY,2010,0,3094,0,3553,0,0,6647
Egypt,EGY,2020,0,3722,0,0,0,0,3722
Egypt,EGY,2021,0,275,0,0,0,0,275
Egypt,EGY,1926,0,0,8816,0,0,0,8816
Egypt,EGY,1955,0,0,8389,0,0,0,8389
Egypt,EGY,1969,0,0,588,0,0,0,588
Egypt,EGY,1992,0,0,92017,0,0,0,92017
Egypt,EGY,1987,0,0,0,5677,0,0,5677
Egypt,EGY,2004,0,0,0,1677,0,0,1677
Egypt,EGY,2015,0,0,0,3172,11256,0,14428
Egypt,EGY,2016,0,0,0,2606,0,0,2606
Egypt,EGY,2000,0,0,0,0,420,0,420
Egypt,EGY,1993,0,0,0,0,0,5539,5539
Egypt,EGY,2008,0,0,0,0,0,11688,11688
El Salvador,SLV,1982,0,1086979,43479,0,0,0,1130458
El Salvador,SLV,1994,0,0,0,0,0,0,0
El Salvador,SLV,1998,0,0,0,807125,0,0,807125
El Salvador,SLV,2001,0,0,1935505,0,0,0,1935505
El Salvador,SLV,2009,0,0,0,451472,0,0,451472
El Salvador,SLV,2014,0,0,0,0,0,0,0
El Salvador,SLV,2018,0,6373,0,0,0,0,6373
El Salvador,SLV,1988,0,63824,0,0,0,42550,106374
El Salvador,SLV,1989,0,18972,0,0,0,0,18972
El Salvador,SLV,1992,0,3602,0,0,0,0,3602
El Salvador,SLV,1995,0,13917,0,0,0,0,13917
El Salvador,SLV,1999,0,11817,0,0,0,0,11817
El Salvador,SLV,2000,0,3357,0,1678,0,0,5035
El Salvador,SLV,2002,0,1664,0,0,0,0,1664
El Salvador,SLV,2005,0,79499,1656,114280,0,3312,198747
El Salvador,SLV,2007,0,3309,0,0,0,0,3309
El Salvador,SLV,2008,0,49439,0,0,0,0,49439
El Salvador,SLV,2011,0,57028,0,0,0,0,57028
El Salvador,SLV,2015,0,1605,0,19258,0,0,20863
El Salvador,SLV,2021,0,7919,0,0,0,0,7919
El Salvador,SLV,1936,0,0,2308364,0,0,0,2308364
El Salvador,SLV,1951,0,0,4927976,0,0,0,4927976
El Salvador,SLV,1965,0,0,393142,0,0,0,393142
El Salvador,SLV,1986,0,0,2212928,0,0,0,2212928
El Salvador,SLV,2006,0,0,0,0,1657,0,1657
El Salvador,SLV,2019,0,0,1592,0,0,0,1592
El Salvador,SLV,1934,0,0,0,11831484,0,0,11831484
El Salvador,SLV,1969,0,0,0,5664,0,0,5664
El Salvador,SLV,1996,0,0,0,20700,0,0,20700
El Salvador,SLV,1997,0,0,0,6846,0,0,6846
El Salvador,SLV,2010,0,0,0,27805,0,0,27805
El Salvador,SLV,2017,0,0,0,15957,0,0,15957
El Salvador,SLV,2020,0,0,0,52441,0,66744,119185
El Salvador,SLV,2022,0,0,0,17360,0,0,17360
El Salvador,SLV,2013,0,0,0,0,0,0,0
El Salvador,SLV,1993,0,0,0,0,0,39069,39069
Eritrea,ERI,1993,0,0,0,15141,0,0,15141
Eritrea,ERI,1999,0,0,0,0,0,0,0
Eritrea,ERI,2008,0,0,0,0,0,0,0
Eritrea,ERI,2003,0,0,0,0,0,0,0
Eritrea,ERI,2004,0,0,0,0,0,0,0
Estonia,EST,2005,0,0,0,0,22146,0,22146
Estonia,EST,2012,0,0,0,0,7560,0,7560
Estonia,EST,2018,0,0,0,0,52944,0,52944
Estonia,EST,2022,0,0,0,0,1259366,0,1259366
Ethiopia,ETH,1965,808816,0,0,0,0,0,808816
Ethiopia,ETH,1969,0,0,8718,0,0,0,8718
Ethiopia,ETH,1973,32579315,0,0,0,0,0,32579315
Ethiopia,ETH,1983,78461760,0,0,0,0,0,78461760
Ethiopia,ETH,1987,85644,0,0,0,0,0,85644
Ethiopia,ETH,1989,0,0,0,0,0,0,0
Ethiopia,ETH,1997,0,53239,0,0,0,0,53239
Ethiopia,ETH,1998,0,0,0,0,0,0,0
Ethiopia,ETH,1999,0,7376,0,0,0,0,7376
Ethiopia,ETH,2003,0,16264,0,0,0,0,16264
Ethiopia,ETH,2005,0,27236,0,0,0,0,27236
Ethiopia,ETH,2008,0,5334,0,0,0,0,5334
Ethiopia,ETH,2009,0,0,0,0,0,0,0
Ethiopia,ETH,2010,0,2129,0,0,0,0,2129
Ethiopia,ETH,2011,0,0,0,0,0,0,0
Ethiopia,ETH,2015,0,0,0,0,0,0,0
Ethiopia,ETH,2021,0,1330,0,0,0,0,1330
Ethiopia,ETH,2022,0,0,0,0,0,0,0
Ethiopia,ETH,1968,0,373,0,0,0,0,373
Ethiopia,ETH,1976,0,0,0,0,0,0,0
Ethiopia,ETH,1977,0,2077,0,0,0,18994,21071
Ethiopia,ETH,1978,0,2627,0,0,0,0,2627
Ethiopia,ETH,1981,0,0,0,0,0,0,0
Ethiopia,ETH,1985,0,2234,0,0,0,0,2234
Ethiopia,ETH,1988,0,10110,0,0,0,0,10110
Ethiopia,ETH,1990,0,0,0,0,0,0,0
Ethiopia,ETH,1993,0,372,0,0,0,0,372
Ethiopia,ETH,1994,0,719,0,0,0,3955,4674
Ethiopia,ETH,1995,0,4698,0,0,0,0,4698
Ethiopia,ETH,1996,0,6740,0,0,0,0,6740
Ethiopia,ETH,2000,0,10294,0,0,0,597,10891
Ethiopia,ETH,2001,0,724,0,0,0,0,724
Ethiopia,ETH,2002,0,3095,0,0,0,0,3095
Ethiopia,ETH,2006,0,119336,0,0,0,0,119336
Ethiopia,ETH,2007,0,2073,0,0,0,610,2683
Ethiopia,ETH,2013,0,0,0,0,0,0,0
Ethiopia,ETH,2016,0,12157,0,0,0,0,12157
Ethiopia,ETH,2019,0,0,0,0,0,2015,2015
Ethiopia,ETH,2020,0,1024,0,0,0,1877,2901
Ethiopia,ETH,2023,0,7192,0,0,0,0,7192
Ethiopia,ETH,1961,0,0,13464,0,0,0,13464
Ethiopia,ETH,2018,0,0,0,0,0,3959,3959
Ethiopia,ETH,1991,0,0,0,0,0,2603,2603
Fiji,FJI,1983,0,0,0,129758,0,0,129758
Fiji,FJI,1998,0,0,0,0,0,0,0
Fiji,FJI,2015,0,0,0,0,0,0,0
Fiji,FJI,1964,0,21967,0,0,0,0,21967
Fiji,FJI,1986,0,255836,0,13465,0,0,269301
Fiji,FJI,1989,0,129414,0,0,0,0,129414
Fiji,FJI,2000,0,48047,0,0,0,0,48047
Fiji,FJI,2004,0,0,0,184609,0,0,184609
Fiji,FJI,2006,0,45295,0,0,0,0,45295
Fiji,FJI,2007,0,67366,0,11228,0,0,78594
Fiji,FJI,2009,0,133128,0,22188,0,0,155316
Fiji,FJI,2012,0,164642,0,21952,0,0,186594
Fiji,FJI,1990,0,0,0,0,0,0,0
Fiji,FJI,1931,0,0,0,9269988,0,0,9269988
Fiji,FJI,1941,0,0,0,216496,0,0,216496
Fiji,FJI,1952,0,0,0,721503,0,0,721503
Fiji,FJI,1958,0,0,0,0,0,0,0
Fiji,FJI,1965,0,0,0,42642,0,0,42642
Fiji,FJI,1972,0,0,0,54752,0,0,54752
Fiji,FJI,1973,0,0,0,1058771,0,0,1058771
Fiji,FJI,1975,0,0,0,0,0,0,0
Fiji,FJI,1978,0,0,0,0,0,0,0
Fiji,FJI,1979,0,0,0,842787,0,0,842787
Fiji,FJI,1980,0,0,0,279245,0,0,279245
Fiji,FJI,1981,0,0,0,0,0,0,0
Fiji,FJI,1985,0,0,0,439883,0,0,439883
Fiji,FJI,1987,0,0,0,13249,0,0,13249
Fiji,FJI,1992,0,0,0,12709,0,0,12709
Fiji,FJI,1993,0,0,0,266089,0,0,266089
Fiji,FJI,1997,0,0,0,310723,0,0,310723
Fiji,FJI,1999,0,0,0,145732,0,0,145732
Fiji,FJI,2001,0,0,0,11886,0,0,11886
Fiji,FJI,2003,0,0,0,198065,0,0,198065
Fiji,FJI,2008,0,0,0,78062,0,0,78062
Fiji,FJI,2010,0,0,0,22095,0,0,22095
Fiji,FJI,2016,0,0,0,511776,0,0,511776
Fiji,FJI,2018,0,0,0,76170,0,0,76170
Fiji,FJI,2019,0,0,0,10888,0,0,10888
Fiji,FJI,2020,0,0,0,86916,0,0,86916
Fiji,FJI,2021,0,0,0,64892,0,0,64892
Fiji,FJI,2022,0,0,0,10755,0,0,10755
Finland,FIN,2005,0,0,0,0,0,0,0
Finland,FIN,1990,0,0,0,0,0,0,0
Finland,FIN,2022,0,0,0,0,406083,0,406083
France,FRA,1982,0,0,0,2209,0,3314,5523
France,FRA,1989,0,0,0,1602,0,0,1602
France,FRA,1991,0,0,0,0,3531,0,3531
France,FRA,1997,0,0,0,0,3977,0,3977
France,FRA,2022,0,0,0,928,743811,0,744739
France,FRA,1958,0,7820,0,0,0,0,7820
France,FRA,1977,0,4913,0,0,0,0,4913
France,FRA,1978,0,564,0,0,0,0,564
France,FRA,1980,0,1117,0,0,0,0,1117
France,FRA,1981,0,0,0,0,0,0,0
France,FRA,1983,0,3297,0,2015,0,4763,10075
France,FRA,1987,0,4134,0,719,0,0,4853
France,FRA,1988,0,1789,0,0,0,0,1789
France,FRA,1992,0,528,0,8441,0,0,8969
France,FRA,1993,0,701,0,2103,0,0,2804
France,FRA,1994,0,2272,0,0,0,0,2272
France,FRA,1996,0,694,0,174,0,0,868
France,FRA,1999,0,6169,0,16966,0,1885,25020
France,FRA,2000,0,852,0,1023,0,0,1875
France,FRA,2001,0,508,0,2372,0,0,2880
France,FRA,2002,0,3874,0,842,0,0,4716
France,FRA,2003,0,1674,0,1005,3263112,837,3266628
France,FRA,2005,0,496,0,0,1322,331,2149
France,FRA,2010,0,4004,0,8488,480,0,12972
France,FRA,2011,0,956,0,0,0,0,956
France,FRA,2013,0,316,0,316,0,0,632
France,FRA,2014,0,2202,0,1258,0,0,3460
France,FRA,2015,0,3134,0,470,513244,0,516848
France,FRA,2016,0,781,0,0,0,0,781
France,FRA,2017,0,156,0,312,0,0,468
France,FRA,2018,0,2178,0,933,467,0,3578
France,FRA,2019,0,1242,0,1242,222827,0,225311
France,FRA,2020,0,310,0,2792,298387,0,301489
France,FRA,2021,0,310,0,0,0,0,310
France,FRA,1909,0,0,11384,0,0,0,11384
France,FRA,1967,0,0,203,1017,0,0,1220
France,FRA,1979,0,0,2059,0,0,0,2059
France,FRA,2023,0,0,0,0,0,0,0
France,FRA,1969,0,0,0,4592,0,0,4592
France,FRA,1976,0,0,0,0,0,0,0
France,FRA,1984,0,0,0,729,0,0,729
France,FRA,1985,0,0,0,0,0,1089,1089
France,FRA,1990,0,0,0,7622,886,2482,10990
France,FRA,1995,0,0,0,2786,0,0,2786
France,FRA,1998,0,0,0,1033,0,1550,2583
France,FRA,2004,0,0,0,1830,0,0,1830
France,FRA,2006,0,0,0,821,227843,0,228664
France,FRA,2007,0,0,0,815,0,0,815
France,FRA,2008,0,0,0,810,324,0,1134
France,FRA,2009,0,0,0,1772,805,0,2577
France,FRA,2012,0,0,0,0,1903,0,1903
France,FRA,1926,0,0,0,0,0,7040,7040
France,FRA,1930,0,0,0,0,0,9848,9848
France,FRA,1932,0,0,0,0,0,7372,7372
France,FRA,1961,0,0,0,0,0,4551,4551
France,FRA,1970,0,0,0,0,0,22564,22564
France,FRA,1949,0,0,0,0,0,19232,19232
France,FRA,1986,0,0,0,0,0,903,903
French Guiana,GUF,1996,0,0,0,0,0,0,0
French Guiana,GUF,2020,0,0,0,0,0,0,0
French Guiana,GUF,2000,0,0,0,0,0,608395,608395
French Polynesia,PYF,2017,0,0,0,0,0,0,0
French Polynesia,PYF,1958,0,0,0,0,0,0,0
French Polynesia,PYF,1983,0,0,0,390939,0,0,390939
French Polynesia,PYF,2010,0,0,0,35237,0,0,35237
French Polynesia,PYF,1987,0,0,0,0,0,507960,507960
French Polynesia,PYF,1998,0,0,0,0,0,535217,535217
Gabon,GAB,1988,0,0,0,0,0,0,0
Gabon,GAB,2012,0,5445,0,0,0,0,5445
Gabon,GAB,2009,0,0,0,0,0,0,0
Gabon,GAB,2010,0,0,0,0,0,0,0
Gabon,GAB,2023,0,0,0,0,0,0,0
Gambia,GMB,1910,0,0,0,0,0,0,0
Gambia,GMB,1940,0,0,0,0,0,0,0
Gambia,GMB,1968,0,0,0,0,0,0,0
Gambia,GMB,1969,0,0,0,0,0,0,0
Gambia,GMB,1976,0,0,0,0,0,0,0
Gambia,GMB,1980,0,0,0,0,0,0,0
Gambia,GMB,2002,0,0,0,0,0,0,0
Gambia,GMB,2012,0,0,0,0,0,0,0
Gambia,GMB,2015,0,0,0,0,0,0,0
Gambia,GMB,1996,0,0,0,0,0,0,0
Gambia,GMB,1999,0,379519,0,0,0,0,379519
Gambia,GMB,2001,0,6759,0,0,0,0,6759
Gambia,GMB,2007,0,0,0,0,0,0,0
Gambia,GMB,2008,0,0,0,0,0,0,0
Gambia,GMB,2009,0,26622,0,0,0,0,26622
Gambia,GMB,2010,0,46457,0,0,0,0,46457
Gambia,GMB,2013,0,9412,0,0,0,0,9412
Gambia,GMB,2017,0,25197,0,0,0,0,25197
Gambia,GMB,2022,0,22173,0,0,0,0,22173
Gambia,GMB,2003,0,0,0,19154,0,0,19154
Gambia,GMB,2004,0,0,0,12405,0,0,12405
Gambia,GMB,2019,0,0,0,15943,0,0,15943
Gambia,GMB,2021,0,0,0,37880,0,0,37880
Gambia,GMB,1973,0,0,0,0,0,0,0
Georgia,GEO,2000,0,0,0,0,0,0,0
Georgia,GEO,1995,0,2050,0,0,0,0,2050
Georgia,GEO,1997,0,15086,0,0,0,0,15086
Georgia,GEO,2004,0,2507,0,0,0,0,2507
Georgia,GEO,2005,0,0,0,0,0,0,0
Georgia,GEO,2006,0,0,0,0,0,0,0
Georgia,GEO,2011,0,18317,0,0,0,0,18317
Georgia,GEO,2012,0,13143,0,0,0,0,13143
Georgia,GEO,2013,0,0,0,0,0,0,0
Georgia,GEO,2014,0,0,0,0,0,0,0
Georgia,GEO,2015,0,106069,0,0,0,0,106069
Georgia,GEO,2018,0,0,0,0,0,0,0
Georgia,GEO,2019,0,0,0,0,0,0,0
Georgia,GEO,2020,0,0,0,0,0,0,0
Georgia,GEO,2021,0,0,0,0,0,0,0
Georgia,GEO,2022,0,0,0,0,0,0,0
Georgia,GEO,2023,0,0,0,0,0,48280,48280
Georgia,GEO,1991,0,0,15032,0,0,0,15032
Georgia,GEO,1992,0,0,1909,0,0,0,1909
Georgia,GEO,2002,0,0,14774,0,0,0,14774
Georgia,GEO,2009,0,0,0,0,0,0,0
Georgia,GEO,2001,0,0,0,0,0,0,0
Germany,DEU,1992,0,0,125,0,0,0,125
Germany,DEU,1993,0,621,0,745,0,0,1366
Germany,DEU,1994,0,247,0,1360,0,0,1607
Germany,DEU,1997,0,0,0,0,3684,0,3684
Germany,DEU,1999,0,858,0,2207,0,613,3678
Germany,DEU,2002,0,3315,0,2701,0,0,6016
Germany,DEU,2005,0,123,0,246,1354,0,1723
Germany,DEU,2006,0,0,0,1355,246,0,1601
Germany,DEU,2007,0,123,0,2217,0,0,2340
Germany,DEU,2009,0,0,0,123,1723,0,1846
Germany,DEU,2010,0,369,0,492,123,0,984
Germany,DEU,2011,0,491,0,0,0,0,491
Germany,DEU,2013,0,490,0,857,0,0,1347
Germany,DEU,2016,0,850,0,0,0,0,850
Germany,DEU,2017,0,0,0,605,0,0,605
Germany,DEU,2021,0,23619,0,120,0,0,23739
Germany,DEU,2004,0,0,0,246,0,0,246
Germany,DEU,1990,0,0,0,8063,0,0,8063
Germany,DEU,1991,0,0,0,0,0,0,0
Germany,DEU,1995,0,0,0,616,0,0,616
Germany,DEU,1996,0,0,0,0,0,0,0
Germany,DEU,1998,0,0,0,368,0,0,368
Germany,DEU,2001,0,0,0,736,0,0,736
Germany,DEU,2003,0,0,0,1844,1150014,0,1151858
Germany,DEU,2008,0,0,0,985,123,0,1108
Germany,DEU,2014,0,0,0,977,0,0,977
Germany,DEU,2018,0,0,0,603,0,0,603
Germany,DEU,2019,0,0,0,120,481,0,601
Germany,DEU,2020,0,0,0,0,0,0,0
Germany,DEU,2022,0,0,0,840,980331,0,981171
Germany,DEU,2023,0,0,0,120,0,0,120
Germany,DEU,2012,0,0,0,0,736,0,736
Ghana,GHA,1971,0,0,0,0,0,0,0
Ghana,GHA,1977,0,0,0,0,0,0,0
Ghana,GHA,1980,0,0,0,0,0,0,0
Ghana,GHA,1968,0,0,0,0,0,0,0
Ghana,GHA,1989,0,4650,0,0,0,0,4650
Ghana,GHA,1991,0,3156,0,0,0,0,3156
Ghana,GHA,1995,0,83148,0,0,0,0,83148
Ghana,GHA,1999,0,27116,0,0,0,0,27116
Ghana,GHA,2001,0,5942,0,0,0,0,5942
Ghana,GHA,2002,0,1927,0,0,0,0,1927
Ghana,GHA,2007,0,23620,0,0,0,0,23620
Ghana,GHA,2008,0,0,0,0,0,0,0
Ghana,GHA,2009,0,16032,0,0,0,0,16032
Ghana,GHA,2010,0,24634,0,0,0,0,24634
Ghana,GHA,2011,0,7632,0,0,0,0,7632
Ghana,GHA,2013,0,1816,0,0,0,0,1816
Ghana,GHA,2015,0,8659,0,0,0,0,8659
Ghana,GHA,2016,0,3384,0,0,0,0,3384
Ghana,GHA,2017,0,0,0,6618,0,0,6618
Ghana,GHA,2018,0,11014,0,0,0,0,11014
Ghana,GHA,2019,0,10152,0,0,0,0,10152
Ghana,GHA,2020,0,2175,0,0,0,0,2175
Ghana,GHA,2021,0,2741,0,0,0,0,2741
Ghana,GHA,2022,0,0,0,0,0,0,0
Ghana,GHA,2023,0,2345,0,0,0,0,2345
Ghana,GHA,1939,0,0,52900,0,0,0,52900
Ghana,GHA,1985,0,0,0,0,0,2930,2930
Greece,GRC,1990,0,0,971,2912,0,0,3883
Greece,GRC,1977,0,30056,0,0,0,0,30056
Greece,GRC,1979,0,16315,0,0,0,0,16315
Greece,GRC,1994,0,13149,0,0,0,0,13149
Greece,GRC,1997,0,8276,0,0,0,0,8276
Greece,GRC,1998,0,2742,0,0,0,12798,15540
Greece,GRC,2000,0,906,0,0,24461,8154,33521
Greece,GRC,2001,0,9935,0,0,0,0,9935
Greece,GRC,2002,0,0,0,1802,0,0,1802
Greece,GRC,2003,0,0,0,0,0,0,0
Greece,GRC,2006,0,900,0,2701,0,0,3601
Greece,GRC,2007,0,1803,0,0,14425,61308,77536
Greece,GRC,2010,0,906,0,0,0,0,906
Greece,GRC,2012,0,912,0,0,4561,0,5473
Greece,GRC,2014,0,0,2762,0,0,0,2762
Greece,GRC,2015,0,2776,0,0,0,0,2776
Greece,GRC,2016,0,3721,0,0,0,0,3721
Greece,GRC,2017,0,21511,2806,0,0,0,24317
Greece,GRC,2020,0,7610,1903,0,0,0,9513
Greece,GRC,1904,0,0,7776,0,0,0,7776
Greece,GRC,1914,0,0,25354,0,0,0,25354
Greece,GRC,1928,0,0,164050,0,0,0,164050
Greece,GRC,1932,0,0,229000,0,0,0,229000
Greece,GRC,1947,0,0,3971,0,0,0,3971
Greece,GRC,1948,0,0,2637,0,0,0,2637
Greece,GRC,1953,0,0,598020,0,0,0,598020
Greece,GRC,1954,0,0,69541,0,0,0,69541
Greece,GRC,1955,0,0,9821,0,0,0,9821
Greece,GRC,1956,0,0,64364,0,0,0,64364
Greece,GRC,1965,0,0,82099,0,0,0,82099
Greece,GRC,1966,0,0,2347,0,0,0,2347
Greece,GRC,1967,0,0,10566,0,0,0,10566
Greece,GRC,1968,0,0,22304,0,0,0,22304
Greece,GRC,1978,0,0,55040,0,0,0,55040
Greece,GRC,1980,0,0,1074,0,0,0,1074
Greece,GRC,1981,0,0,25480,0,0,0,25480
Greece,GRC,1983,0,0,0,0,0,12453,12453
Greece,GRC,1986,0,0,20127,0,0,0,20127
Greece,GRC,1988,0,0,0,0,55335,0,55335
Greece,GRC,1993,0,0,947,0,0,0,947
Greece,GRC,1995,0,0,48472,0,0,0,48472
Greece,GRC,1996,0,0,0,0,0,0,0
Greece,GRC,1999,0,0,130073,0,0,0,130073
Greece,GRC,2008,0,0,1806,0,0,0,1806
Greece,GRC,2021,0,0,957,0,0,1915,2872
Greece,GRC,1930,0,0,0,34231,0,0,34231
Greece,GRC,1961,0,0,0,50431,0,0,50431
Greece,GRC,1987,0,0,0,47861,997094,0,1044955
Greece,GRC,2004,0,0,0,0,0,0,0
Greece,GRC,2019,0,0,0,6620,0,0,6620
Greece,GRC,1985,0,0,0,0,20325,3049,23374
Greece,GRC,1991,0,0,0,0,4812,0,4812
Greece,GRC,2022,0,0,0,0,2977379,0,2977379
Greece,GRC,1984,0,0,0,0,0,0,0
Greece,GRC,2009,0,0,0,0,0,0,0
Greece,GRC,2018,0,0,0,0,0,94044,94044
Greece,GRC,2023,0,0,0,0,0,28043,28043
Grenada,GRD,2010,0,0,0,0,0,0,0
Grenada,GRD,1975,0,0,0,0,0,0,0
Grenada,GRD,1963,0,0,0,619195,0,0,619195
Grenada,GRD,1980,0,0,0,0,0,0,0
Grenada,GRD,1990,0,0,0,0,0,0,0
Grenada,GRD,1999,0,0,0,0,0,0,0
Grenada,GRD,2002,0,0,0,0,0,0,0
Grenada,GRD,2004,0,0,0,3560701,0,0,3560701
Guadeloupe,GLP,1988,0,0,0,0,0,0,0
Guadeloupe,GLP,2004,0,0,24472,0,0,0,24472
Guadeloupe,GLP,1956,0,0,0,0,0,0,0
Guadeloupe,GLP,1964,0,0,0,467697,0,0,467697
Guadeloupe,GLP,1966,0,0,0,813233,0,0,813233
Guadeloupe,GLP,1970,0,0,0,0,0,0,0
Guadeloupe,GLP,1979,0,0,0,0,0,0,0
Guadeloupe,GLP,1989,0,0,0,129577,0,0,129577
Guadeloupe,GLP,1990,0,0,0,0,0,0,0
Guadeloupe,GLP,1995,0,0,0,0,0,0,0
Guadeloupe,GLP,1998,0,0,0,0,0,0,0
Guadeloupe,GLP,1999,0,0,0,93950,0,0,93950
Guadeloupe,GLP,2007,0,0,0,0,0,0,0
Guadeloupe,GLP,2017,0,0,0,100749,0,0,100749
Guadeloupe,GLP,2022,0,0,0,25268,0,0,25268
Guadeloupe,GLP,1976,0,0,0,0,0,0,0
Guam,GUM,1993,0,0,0,0,0,0,0
Guam,GUM,1962,0,0,0,795503,0,0,795503
Guam,GUM,1976,0,0,0,885801,0,0,885801
Guam,GUM,1987,0,0,0,0,0,0,0
Guam,GUM,1992,0,0,0,69840,0,0,69840
Guam,GUM,1997,0,0,0,0,0,0,0
Guam,GUM,2002,0,0,0,61508,0,0,61508
Guam,GUM,2004,0,0,0,60967,0,0,60967
Guam,GUM,2023,0,0,0,115632,0,0,115632
Guatemala,GTM,1987,0,100366,0,0,0,0,100366
Guatemala,GTM,1994,0,9906,0,0,0,0,9906
Guatemala,GTM,2001,34141,0,4996,6662,0,0,45799
Guatemala,GTM,2009,0,0,0,0,0,25246,25246
Guatemala,GTM,2012,0,0,29085,0,0,0,29085
Guatemala,GTM,2014,0,0,636,3182,0,0,3818
Guatemala,GTM,2018,0,1187,0,0,0,273588,274775
Guatemala,GTM,1949,0,133092430,0,0,0,0,133092430
Guatemala,GTM,1973,0,8482,0,0,0,0,8482
Guatemala,GTM,1982,0,845517,0,0,0,0,845517
Guatemala,GTM,1988,0,0,5814,0,0,0,5814
Guatemala,GTM,1989,0,11313,0,0,0,0,11313
Guatemala,GTM,1995,0,29914,0,0,0,0,29914
Guatemala,GTM,1999,0,10468,1745,0,0,0,12213
Guatemala,GTM,2000,0,30675,0,0,0,0,30675
Guatemala,GTM,2002,0,0,0,1627,0,55330,56957
Guatemala,GTM,2005,0,0,0,1152076,0,53302,1205378
Guatemala,GTM,2007,0,8031,0,0,0,0,8031
Guatemala,GTM,2008,0,21460,0,12161,0,19314,52935
Guatemala,GTM,2010,0,0,0,119644,0,36443,156087
Guatemala,GTM,2011,0,39775,2022,3371,0,10786,55954
Guatemala,GTM,2015,0,5000,0,0,0,218735,223735
Guatemala,GTM,2017,0,603,0,4825,0,6635,12063
Guatemala,GTM,2020,0,1728,0,94455,0,0,96183
Guatemala,GTM,2021,0,1136,0,0,0,0,1136
Guatemala,GTM,2022,0,26900,1681,2242,0,0,30823
Guatemala,GTM,2023,0,12713,0,0,0,0,12713
Guatemala,GTM,1902,0,0,14597699,0,0,51091943,65689642
Guatemala,GTM,1917,0,0,16427496,0,0,0,16427496
Guatemala,GTM,1976,0,0,36261966,0,0,0,36261966
Guatemala,GTM,1979,0,0,0,0,0,0,0
Guatemala,GTM,1985,0,0,0,0,0,0,0
Guatemala,GTM,1986,0,0,0,0,0,0,0
Guatemala,GTM,1991,0,0,15006,0,0,24653,39659
Guatemala,GTM,2013,0,0,648,0,0,0,648
Guatemala,GTM,1969,0,0,0,506754,0,0,506754
Guatemala,GTM,1996,0,0,0,0,0,0,0
Guatemala,GTM,1998,0,0,0,343347,0,45601,388948
Guatemala,GTM,2016,0,0,0,0,0,6138,6138
Guatemala,GTM,2019,0,0,0,2338,0,0,2338
Guatemala,GTM,2006,0,0,0,0,4473,0,4473
Guatemala,GTM,1983,0,0,0,0,0,0,0
Guatemala,GTM,1984,0,0,0,0,0,0,0
Guatemala,GTM,1992,0,0,0,0,0,0,0
Guatemala,GTM,2003,0,0,0,0,0,17501,17501
Guinea,GIN,1980,0,0,0,0,0,0,0
Guinea,GIN,1998,15014,0,0,0,0,0,15014
Guinea,GIN,1981,0,0,0,0,0,0,0
Guinea,GIN,1993,0,0,0,0,0,0,0
Guinea,GIN,2001,0,10656,0,0,0,0,10656
Guinea,GIN,2006,0,0,0,0,0,0,0
Guinea,GIN,2007,0,0,0,0,0,0,0
Guinea,GIN,2008,0,0,0,0,0,0,0
Guinea,GIN,2009,0,1996,0,0,0,0,1996
Guinea,GIN,2010,0,7789,0,0,0,0,7789
Guinea,GIN,2011,0,0,0,0,0,0,0
Guinea,GIN,2013,0,0,0,0,0,0,0
Guinea,GIN,2015,0,7741,0,0,0,6021,13762
Guinea,GIN,2017,0,0,0,0,0,0,0
Guinea,GIN,2020,0,0,0,0,0,0,0
Guinea,GIN,2021,0,3695,0,0,0,0,3695
Guinea,GIN,2022,0,0,0,0,0,0,0
Guinea,GIN,2023,0,4933,0,0,0,0,4933
Guinea,GIN,1983,0,0,838653,0,0,0,838653
Guinea,GIN,2000,0,0,0,4798,0,0,4798
Guinea,GIN,2004,0,0,0,0,0,0,0
Guinea-Bissau,GNB,1910,0,0,0,0,0,0,0
Guinea-Bissau,GNB,1940,0,0,0,0,0,0,0
Guinea-Bissau,GNB,1969,0,0,0,0,0,0,0
Guinea-Bissau,GNB,1980,0,0,0,0,0,0,0
Guinea-Bissau,GNB,2002,0,0,0,0,0,0,0
Guinea-Bissau,GNB,2006,0,0,0,0,0,0,0
Guinea-Bissau,GNB,2003,0,0,0,0,0,0,0
Guinea-Bissau,GNB,2004,0,22272,0,0,0,0,22272
Guinea-Bissau,GNB,2008,0,0,0,0,0,0,0
Guinea-Bissau,GNB,2010,0,12761,0,0,0,0,12761
Guinea-Bissau,GNB,1987,0,0,0,10771,0,0,10771
Guinea-Bissau,GNB,1993,0,0,0,0,0,0,0
Guinea-Bissau,GNB,2018,0,0,0,15585,0,0,15585
Guinea-Bissau,GNB,1998,0,0,0,0,0,25336,25336
Guyana,GUY,1988,0,0,0,0,0,0,0
Guyana,GUY,1997,0,0,0,0,0,0,0
Guyana,GUY,2010,0,0,0,0,0,0,0
Guyana,GUY,1971,0,0,0,0,0,0,0
Guyana,GUY,1989,0,0,0,0,0,0,0
Guyana,GUY,1996,0,0,0,0,0,0,0
Guyana,GUY,2005,0,447537,0,0,0,0,447537
Guyana,GUY,2006,0,0,0,0,0,0,0
Guyana,GUY,2008,0,0,0,0,0,0,0
Guyana,GUY,2015,0,0,0,0,0,0,0
Guyana,GUY,2017,0,0,0,0,0,0,0
Guyana,GUY,2021,0,0,0,0,0,0,0
Guyana,GUY,2022,0,0,0,0,0,0,0
Haiti,HTI,1968,0,0,0,0,0,0,0
Haiti,HTI,1974,0,0,0,0,0,0,0
Haiti,HTI,1977,0,0,0,0,0,0,0
Haiti,HTI,1980,0,0,0,389609,0,0,389609
Haiti,HTI,1992,0,0,0,0,0,0,0
Haiti,HTI,1993,0,17697,0,0,0,0,17697
Haiti,HTI,2003,0,70357,0,29504,0,0,99861
Haiti,HTI,2014,0,11524,0,0,0,0,11524
Haiti,HTI,2016,0,49469,0,509621,0,0,559090
Haiti,HTI,1959,0,130625,0,0,0,0,130625
Haiti,HTI,1962,0,64205,0,0,0,0,64205
Haiti,HTI,1963,0,1212926,0,12129257,0,0,13342183
Haiti,HTI,1972,0,160721,0,0,0,0,160721
Haiti,HTI,1986,0,232153,0,0,0,0,232153
Haiti,HTI,1987,0,50704,0,0,0,0,50704
Haiti,HTI,1988,0,40632,0,81265,0,0,121897
Haiti,HTI,1989,0,0,0,0,0,0,0
Haiti,HTI,1996,0,23164,0,84936,0,0,108100
Haiti,HTI,1999,0,15836,0,0,0,0,15836
Haiti,HTI,2000,0,19138,0,0,0,0,19138
Haiti,HTI,2001,0,30546,0,0,0,0,30546
Haiti,HTI,2002,0,35790,0,4618,0,0,40408
Haiti,HTI,2004,0,2973834,0,3076496,0,0,6050330
Haiti,HTI,2005,0,18657,0,77920,0,0,96577
Haiti,HTI,2006,0,11871,0,5396,0,0,17267
Haiti,HTI,2007,0,64750,0,108271,0,0,173021
Haiti,HTI,2009,0,21581,0,0,0,0,21581
Haiti,HTI,2010,0,44702,226122780,27431,0,0,226194913
Haiti,HTI,2011,0,36165,0,3014,0,0,39179
Haiti,HTI,2012,0,41549,0,87055,0,0,128604
Haiti,HTI,2013,0,5847,0,0,0,0,5847
Haiti,HTI,2015,0,5680,0,4733,0,0,10413
Haiti,HTI,2017,0,28536,0,3682,0,0,32218
Haiti,HTI,2019,0,12544,0,0,0,0,12544
Haiti,HTI,2021,0,6115,2249385,0,0,0,2255500
Haiti,HTI,2022,0,6042,1726,0,0,0,7768
Haiti,HTI,2023,0,66526,0,0,0,0,66526
Haiti,HTI,1952,0,0,17864,0,0,0,17864
Haiti,HTI,2018,0,0,15437,0,0,0,15437
Haiti,HTI,1909,0,0,0,809203,0,0,809203
Haiti,HTI,1915,0,0,0,7820175,0,0,7820175
Haiti,HTI,1935,0,0,0,7970467,0,0,7970467
Haiti,HTI,1954,0,0,0,1177829,0,752662,1930491
Haiti,HTI,1964,0,0,0,238302,0,0,238302
Haiti,HTI,1966,0,0,0,1102698,0,0,1102698
Haiti,HTI,1979,0,0,0,14450,0,0,14450
Haiti,HTI,1990,0,0,0,0,0,0,0
Haiti,HTI,1994,0,0,0,1498779,0,0,1498779
Haiti,HTI,1998,0,0,0,235706,0,0,235706
Haiti,HTI,2008,0,0,0,728963,0,0,728963
Haiti,HTI,2020,0,0,0,34493,0,0,34493
Honduras,HND,1965,0,0,0,0,0,0,0
Honduras,HND,1972,0,0,0,0,0,0,0
Honduras,HND,1994,0,267118,0,0,0,0,267118
Honduras,HND,1997,0,0,0,0,0,0,0
Honduras,HND,2000,0,0,0,0,0,0,0
Honduras,HND,2001,0,0,0,30711,0,0,30711
Honduras,HND,2002,0,15670,0,0,0,0,15670
Honduras,HND,2004,0,0,0,0,0,0,0
Honduras,HND,2009,0,0,8457,0,0,0,8457
Honduras,HND,2012,0,0,0,0,0,0,0
Honduras,HND,2014,0,4382,0,0,0,0,4382
Honduras,HND,2018,0,6127,0,0,0,0,6127
Honduras,HND,2023,0,0,0,0,0,0,0
Honduras,HND,1976,0,59973,0,0,0,0,59973
Honduras,HND,1979,0,2730,0,0,0,0,2730
Honduras,HND,1981,0,0,0,0,0,0,0
Honduras,HND,1984,0,0,0,0,0,0,0
Honduras,HND,1986,0,0,0,0,0,0,0
Honduras,HND,1988,0,39765,0,0,0,0,39765
Honduras,HND,1990,0,9895,0,0,0,0,9895
Honduras,HND,1993,0,751340,0,0,0,0,751340
Honduras,HND,1995,0,24085,0,30966,0,0,55051
Honduras,HND,1996,0,11712,0,1673,0,0,13385
Honduras,HND,1999,0,52490,0,0,0,0,52490
Honduras,HND,2003,0,13885,0,0,0,0,13885
Honduras,HND,2005,0,10576,0,70063,0,0,80639
Honduras,HND,2006,0,5164,0,0,0,0,5164
Honduras,HND,2007,0,7571,0,1262,0,0,8833
Honduras,HND,2008,0,82698,0,0,0,0,82698
Honduras,HND,2010,0,144363,0,26033,0,0,170396
Honduras,HND,2011,0,38272,0,0,0,0,38272
Honduras,HND,2016,0,6342,0,1057,0,0,7399
Honduras,HND,2017,0,18698,0,3116,0,0,21814
Honduras,HND,2020,0,2964,0,127448,0,0,130412
Honduras,HND,2022,0,8627,0,4793,0,0,13420
Honduras,HND,1982,0,0,0,323734,0,0,323734
Honduras,HND,1931,0,0,0,14339563,0,0,14339563
Honduras,HND,1961,0,0,0,1285088,0,0,1285088
Honduras,HND,1969,0,0,0,0,0,0,0
Honduras,HND,1971,0,0,0,0,0,0,0
Honduras,HND,1974,0,0,0,25505780,0,0,25505780
Honduras,HND,1978,0,0,0,0,0,0,0
Honduras,HND,1998,0,0,0,23143234,0,0,23143234
Honduras,HND,1973,0,0,0,0,0,9190208,9190208
Honduras,HND,2021,0,0,0,0,0,0,0
Honduras,HND,1989,0,0,0,0,0,20351,20351
Hong Kong,HKG,1960,0,48159,0,144477,0,0,192636
Hong Kong,HKG,1966,0,176407,0,40709,0,173693,390809
Hong Kong,HKG,1976,0,0,0,83354,0,0,83354
Hong Kong,HKG,1977,0,0,0,2144,0,0,2144
Hong Kong,HKG,1979,0,0,0,26679,0,0,26679
Hong Kong,HKG,1981,0,0,0,0,0,0,0
Hong Kong,HKG,1983,0,1904,0,41888,0,0,43792
Hong Kong,HKG,1961,0,0,0,21660,0,0,21660
Hong Kong,HKG,1969,0,0,0,0,0,0,0
Hong Kong,HKG,1970,0,0,0,0,0,0,0
Hong Kong,HKG,1972,0,334275,0,0,0,242229,576504
Hong Kong,HKG,1975,0,6740,0,0,0,0,6740
Hong Kong,HKG,1978,0,0,0,23067,0,0,23067
Hong Kong,HKG,1982,0,1935,0,9677,0,48385,59997
Hong Kong,HKG,1985,0,0,0,3696,0,0,3696
Hong Kong,HKG,1987,0,0,0,0,17926,0,17926
Hong Kong,HKG,1989,0,5215,0,15645,0,0,20860
Hong Kong,HKG,1992,0,8323,0,3329,0,0,11652
Hong Kong,HKG,1994,0,1621,0,0,0,0,1621
Hong Kong,HKG,1997,0,124200,0,1552,0,0,125752
Hong Kong,HKG,2005,0,0,0,0,0,0,0
Hong Kong,HKG,1906,0,0,0,259288350,0,0,259288350
Hong Kong,HKG,1923,0,0,0,1479723,0,0,1479723
Hong Kong,HKG,1937,0,0,0,86920447,0,0,86920447
Hong Kong,HKG,1947,0,0,0,11617283,0,0,11617283
Hong Kong,HKG,1957,0,0,0,29321,0,0,29321
Hong Kong,HKG,1959,0,0,0,144051,0,0,144051
Hong Kong,HKG,1962,0,0,0,549353,0,0,549353
Hong Kong,HKG,1964,0,0,0,199160,0,0,199160
Hong Kong,HKG,1965,0,0,0,13881,0,0,13881
Hong Kong,HKG,1967,0,0,0,0,0,0,0
Hong Kong,HKG,1968,0,0,0,0,0,57381,57381
Hong Kong,HKG,1971,0,0,0,285459,0,0,285459
Hong Kong,HKG,1973,0,0,0,2361,0,0,2361
Hong Kong,HKG,1974,0,0,0,2303,0,0,2303
Hong Kong,HKG,1980,0,0,0,4017,0,0,4017
Hong Kong,HKG,1986,0,0,0,9103,0,0,9103
Hong Kong,HKG,1988,0,0,0,0,0,0,0
Hong Kong,HKG,1991,0,0,0,37140,0,0,37140
Hong Kong,HKG,1993,0,0,0,11495,0,1642,13137
Hong Kong,HKG,1999,0,0,0,3011,0,0,3011
Hong Kong,HKG,2003,0,0,0,5808,0,0,5808
Hong Kong,HKG,2008,0,0,0,2837,0,0,2837
Hong Kong,HKG,2009,0,0,0,0,0,0,0
Hong Kong,HKG,2010,0,0,0,1402,0,0,1402
Hong Kong,HKG,2017,0,0,0,0,0,0,0
Hong Kong,HKG,2018,0,0,0,0,0,0,0
Hong Kong,HKG,2021,0,0,0,2669,0,0,2669
Hungary,HUN,1986,0,0,0,0,0,0,0
Hungary,HUN,1992,0,0,0,0,0,0,0
Hungary,HUN,2003,0,0,0,6918,0,0,6918
Hungary,HUN,1970,0,290828,0,0,0,0,290828
Hungary,HUN,1996,0,0,0,0,0,0,0
Hungary,HUN,1997,0,0,0,0,0,0,0
Hungary,HUN,1999,0,7820,0,39100,0,0,46920
Hungary,HUN,2000,0,980,0,0,0,0,980
Hungary,HUN,2001,0,0,0,0,79584,0,79584
Hungary,HUN,2002,0,0,0,0,0,0,0
Hungary,HUN,2004,0,0,0,0,0,0,0
Hungary,HUN,2005,0,0,0,3971,47650,0,51621
Hungary,HUN,2006,0,0,0,4972,0,0,4972
Hungary,HUN,2010,0,1001,0,0,0,0,1001
Hungary,HUN,2013,0,0,0,0,0,0,0
Hungary,HUN,2014,0,0,0,0,0,0,0
Hungary,HUN,2016,0,0,0,0,0,0,0
Hungary,HUN,1984,0,0,0,3780,0,0,3780
Hungary,HUN,2017,0,0,0,0,0,0,0
Hungary,HUN,2019,0,0,0,0,0,0,0
Hungary,HUN,2007,0,0,0,0,497950,0,497950
Hungary,HUN,2008,0,0,0,0,16960,0,16960
Hungary,HUN,2012,0,0,0,0,16126,0,16126
Hungary,HUN,2018,0,0,0,0,183095,0,183095
Hungary,HUN,2022,0,0,0,0,514683,0,514683
Iceland,ISL,1988,0,0,0,0,0,0,0
Iceland,ISL,1976,0,0,45402,0,0,0,45402
Iceland,ISL,2000,0,0,0,0,0,0,0
Iceland,ISL,1973,0,0,0,0,0,0,0
Iceland,ISL,1983,0,0,0,0,0,168677,168677
Iceland,ISL,1984,0,0,0,0,0,0,0
Iceland,ISL,1996,0,0,0,0,0,0,0
Iceland,ISL,2010,0,0,0,0,0,0,0
Iceland,ISL,1974,0,0,0,0,0,557385,557385
Iceland,ISL,1995,0,0,0,0,0,1270131,1270131
India,IND,1900,44529282,0,0,0,0,0,44529282
India,IND,1942,40214490,0,0,1072386,0,0,41286876
India,IND,1964,0,4744,0,10224,0,0,14968
India,IND,1965,29993143,0,0,0,2000,0,29995143
India,IND,1972,0,0,0,3946,0,0,3946
India,IND,1979,0,3714,0,8719,5872,3993,22298
India,IND,1982,0,12782,0,10203,5486,0,28471
India,IND,1987,3678,16109,0,2035,1226,0,23048
India,IND,1993,0,14001,105230,2008,0,216,121455
India,IND,1996,0,13130,0,15631,0,488,29249
India,IND,2000,189,19686,0,0,2595,1765,24235
India,IND,2002,0,6692,18,1311,17572,0,25593
India,IND,2009,0,12259,0,1782,1798,449,16288
India,IND,2015,0,6342,741,1603,16993,23,25702
India,IND,2018,0,5186,0,4565,321,124,10196
India,IND,1926,0,0,0,0,0,0,0
India,IND,1928,0,1114,0,0,0,0,1114
India,IND,1950,0,4061,42014,2521,0,0,48596
India,IND,1953,0,2098,0,0,10492,0,12590
India,IND,1956,0,3680,2772,0,0,662,7114
India,IND,1957,0,4485,0,0,0,0,4485
India,IND,1958,0,117,0,0,15271,1220,16608
India,IND,1959,0,14246,0,0,0,0,14246
India,IND,1960,0,5314,0,0,0,0,5314
India,IND,1961,0,66988,0,0,8765,0,75753
India,IND,1962,0,3704,0,0,0,0,3704
India,IND,1963,0,4185,0,6528,0,0,10713
India,IND,1966,0,920,294,352,0,0,1566
India,IND,1967,0,5747,3391,19158,0,0,28296
India,IND,1968,0,120953,0,131,0,18747,139831
India,IND,1970,0,18421,466,0,0,0,18887
India,IND,1971,0,23211,0,170491,0,0,193702
India,IND,1974,0,4264,0,328,0,0,4592
India,IND,1975,0,5613,754,8035,0,0,14402
India,IND,1977,0,8593,0,217989,0,0,226582
India,IND,1978,0,69191,0,12172,2251,961,84575
India,IND,1980,0,34600,187,2196,1851,2153,40987
India,IND,1981,0,7757,0,11292,4208,0,23257
India,IND,1983,0,10525,0,10485,0,898,21908
India,IND,1984,0,9700,262,6869,3801,0,20632
India,IND,1985,0,21224,0,2281,4204,0,27709
India,IND,1986,0,3146,75,4888,0,1918,10027
India,IND,1988,0,25188,4582,888,5397,6057,42112
India,IND,1989,0,18885,0,1092,1491,1009,22477
India,IND,1990,0,2573,0,21173,3033,345,27124
India,IND,1991,0,11429,16874,1406,0,0,29709
India,IND,1992,0,8220,0,937,3030,661,12848
India,IND,1994,0,21317,0,2317,1703,0,25337
India,IND,1995,0,15701,0,2302,5787,6637,30427
India,IND,1997,0,23515,429,249,0,509,24702
India,IND,1998,0,20863,0,33982,25856,3662,84363
India,IND,1999,0,5324,961,99741,1346,58,107430
India,IND,2001,0,5385,185408,918,1603,908,194222
India,IND,2003,0,4045,0,1468,14408,224,20145
India,IND,2004,0,11863,144236,0,0,0,156099
India,IND,2005,0,18439,11337,710,4408,2269,37163
India,IND,2006,0,10184,0,1621,401,0,12206
India,IND,2007,0,17240,0,0,1555,0,18795
India,IND,2008,0,13176,0,920,580,307,14983
India,IND,2010,0,5562,0,2313,2015,137,10027
India,IND,2011,0,4835,891,843,1686,0,8255
India,IND,2012,0,2189,0,314,2071,126,4700
India,IND,2013,0,49979,23,821,4314,0,55137
India,IND,2014,0,4758,0,910,1377,1155,8200
India,IND,2016,0,4975,60,956,2241,202,8434
India,IND,2017,0,7724,0,6941,1949,709,17323
India,IND,2019,0,14626,0,1244,810,0,16680
India,IND,2020,0,15067,0,867,0,652,16586
India,IND,2021,0,11062,14,1769,0,2259,15104
India,IND,2022,0,14804,0,141,176,473,15594
India,IND,2023,0,4347,0,245,763,448,5803
India,IND,1905,0,0,694283,0,0,0,694283
India,IND,1916,0,0,0,10073,0,0,10073
India,IND,1924,0,0,0,39955,0,0,39955
India,IND,1925,0,0,0,2549,0,0,2549
India,IND,1927,0,0,0,21411,0,0,21411
India,IND,1935,0,0,0,1701932,0,0,1701932
India,IND,1936,0,0,0,6507,0,0,6507
India,IND,1943,0,0,0,135052,0,0,135052
India,IND,1944,0,0,0,8273,0,0,8273
India,IND,1945,0,0,0,0,0,0,0
India,IND,1949,0,0,0,28098,0,0,28098
India,IND,1952,0,0,0,20107,0,0,20107
India,IND,1955,0,0,0,53189,0,0,53189
India,IND,1969,0,0,0,14945,0,0,14945
India,IND,1976,0,0,0,4236,0,0,4236
India,IND,1973,0,0,0,0,4378,0,4378
India,IND,1948,0,0,0,0,0,14018,14018
India,IND,1954,0,0,0,0,0,770,770
Indonesia,IDN,1966,772491,16995,0,0,0,105059,894545
Indonesia,IDN,1972,0,0,0,0,0,0,0
Indonesia,IDN,1978,4460,4956,0,0,0,0,9416
Indonesia,IDN,1982,18038,193,837,129,0,19648,38845
Indonesia,IDN,1984,14168,1602,123,0,0,0,15893
Indonesia,IDN,1986,4966,10347,0,0,0,0,15313
Indonesia,IDN,1987,0,11657,7366,0,0,7598,26621
Indonesia,IDN,1997,32840,0,977,0,0,11777,45594
Indonesia,IDN,2003,0,18558,45,0,0,5334,23937
Indonesia,IDN,2015,425,347,0,0,0,2470,3242
Indonesia,IDN,2023,0,216,216,36,0,2162,2630
Indonesia,IDN,1953,0,15362,0,0,0,0,15362
Indonesia,IDN,1967,0,15057,13081,0,0,0,28138
Indonesia,IDN,1968,0,1100,18325,0,0,0,19425
Indonesia,IDN,1970,0,7116,0,0,0,0,7116
Indonesia,IDN,1976,0,12117,83704,1858,0,2974,100653
Indonesia,IDN,1977,0,1596,13564,73,0,0,15233
Indonesia,IDN,1979,0,11334,44093,0,0,19351,74778
Indonesia,IDN,1980,0,10325,0,0,0,6749,17074
Indonesia,IDN,1981,0,33556,20173,0,0,12658,66387
Indonesia,IDN,1983,0,1260,126,0,0,1322,2708
Indonesia,IDN,1985,0,2533,603,0,0,0,3136
Indonesia,IDN,1988,0,10188,0,0,0,2846,13034
Indonesia,IDN,1989,0,1006,6706,0,0,335,8047
Indonesia,IDN,1990,0,10485,329,0,0,1812,12626
Indonesia,IDN,1991,0,6042,1511,0,0,4855,12408
Indonesia,IDN,1992,0,3023,132585,0,0,3978,139586
Indonesia,IDN,1993,0,6832,0,0,0,156,6988
Indonesia,IDN,1994,0,3027,23291,0,0,4925,31243
Indonesia,IDN,1995,0,7066,4996,0,0,0,12062
Indonesia,IDN,1996,0,4320,8690,0,0,1142,14152
Indonesia,IDN,1998,0,192,1636,0,0,144,1972
Indonesia,IDN,1999,0,569,237,0,0,4218,5024
Indonesia,IDN,2000,0,12332,6960,0,0,5886,25178
Indonesia,IDN,2001,0,18516,0,0,0,8521,27037
Indonesia,IDN,2002,0,10449,500,0,0,1454,12403
Indonesia,IDN,2004,0,221,7338985,177,0,5355,7344738
Indonesia,IDN,2005,0,6731,40034,0,0,7342,54107
Indonesia,IDN,2006,0,27826,284386,0,0,7938,320150
Indonesia,IDN,2007,0,18650,4045,0,0,1831,24526
Indonesia,IDN,2008,0,4707,462,0,0,883,6052
Indonesia,IDN,2009,0,5229,55191,0,0,1203,61623
Indonesia,IDN,2010,0,16843,22417,0,0,13770,53030
Indonesia,IDN,2011,0,2509,445,0,0,2266,5220
Indonesia,IDN,2012,0,1639,520,839,0,1279,4277
Indonesia,IDN,2013,0,3514,1974,0,0,1342,6830
Indonesia,IDN,2014,0,3005,0,0,0,6479,9484
Indonesia,IDN,2016,0,3399,3972,0,0,2941,10312
Indonesia,IDN,2017,0,1664,151,416,0,1512,3743
Indonesia,IDN,2018,0,2996,177072,0,0,18759,198827
Indonesia,IDN,2019,0,12093,2003,0,0,3301,17397
Indonesia,IDN,2020,0,7320,0,0,0,405,7725
Indonesia,IDN,2021,0,2192,4457,8256,0,3763,18668
Indonesia,IDN,2022,0,1996,12668,0,0,0,14664
Indonesia,IDN,1913,0,0,31235,0,0,0,31235
Indonesia,IDN,1914,0,0,4480,0,0,0,4480
Indonesia,IDN,1917,0,0,3272411,0,0,0,3272411
Indonesia,IDN,1924,0,0,158541,0,0,0,158541
Indonesia,IDN,1927,0,0,9715,0,0,0,9715
Indonesia,IDN,1928,0,0,24571,0,0,0,24571
Indonesia,IDN,1932,0,0,1092,0,0,0,1092
Indonesia,IDN,1936,0,0,4462,0,0,0,4462
Indonesia,IDN,1938,0,0,0,0,0,0,0
Indonesia,IDN,1943,0,0,33073,0,0,0,33073
Indonesia,IDN,1950,0,0,2300,0,0,0,2300
Indonesia,IDN,1958,0,0,954,0,0,0,954
Indonesia,IDN,1965,0,0,7019,0,0,0,7019
Indonesia,IDN,1969,0,0,5707,0,0,0,5707
Indonesia,IDN,1971,0,0,84,0,0,0,84
Indonesia,IDN,1956,0,0,0,37659,0,0,37659
Indonesia,IDN,1973,0,0,0,132308,0,0,132308
Indonesia,IDN,1974,0,0,0,782,0,0,782
Indonesia,IDN,1919,0,0,0,0,0,1070494,1070494
Indonesia,IDN,1930,0,0,0,0,0,256260,256260
Indonesia,IDN,1931,0,0,0,0,0,239997,239997
Indonesia,IDN,1951,0,0,0,0,0,183049,183049
Indonesia,IDN,1954,0,0,0,0,0,4873,4873
Indonesia,IDN,1963,0,0,0,0,0,176110,176110
Indonesia,IDN,1955,0,0,0,0,0,52096,52096
Iran,IRN,1964,0,0,0,0,0,0,0
Iran,IRN,1999,0,12563,3257,0,0,0,15820
Iran,IRN,2021,0,1251,341,1365,0,0,2957
Iran,IRN,1950,0,30892,11882,0,0,0,42774
Iran,IRN,1951,0,130665,0,0,0,0,130665
Iran,IRN,1953,0,406270,544469,0,87692,0,1038431
Iran,IRN,1954,0,1084900,0,0,0,0,1084900
Iran,IRN,1956,0,517266,181043,0,0,0,698309
Iran,IRN,1957,0,61598,2799164,0,0,0,2860762
Iran,IRN,1966,0,16536,0,0,0,0,16536
Iran,IRN,1968,0,11163,3995490,0,0,0,4006653
Iran,IRN,1969,0,7235,18087,0,0,0,25322
Iran,IRN,1980,0,66458,12980,0,0,0,79438
Iran,IRN,1981,0,14329,790587,49412,0,0,854328
Iran,IRN,1986,0,54178,204,0,0,0,54382
Iran,IRN,1987,0,171146,396,0,0,0,171542
Iran,IRN,1988,0,17271,192,0,0,0,17463
Iran,IRN,1989,0,0,18641,0,0,0,18641
Iran,IRN,1990,0,0,7173042,0,0,3764,7176806
Iran,IRN,1991,0,9657,0,3794,0,0,13451
Iran,IRN,1992,0,10611,842,0,0,0,11453
Iran,IRN,1993,0,130699,4016,0,0,0,134715
Iran,IRN,1994,0,6502,2334,0,0,0,8836
Iran,IRN,1995,0,4441,0,0,0,0,4441
Iran,IRN,1996,0,7955,0,1461,0,0,9416
Iran,IRN,1997,0,2081,443018,0,0,0,445099
Iran,IRN,1998,0,24739,3467,0,0,5042,33248
Iran,IRN,2000,0,1526,153,458,0,0,2137
Iran,IRN,2001,0,71391,0,0,0,0,71391
Iran,IRN,2002,0,9060,34162,0,0,0,43222
Iran,IRN,2003,0,0,3943362,0,0,2943,3946305
Iran,IRN,2004,0,5792,5068,0,0,0,10860
Iran,IRN,2005,0,15531,89053,0,0,0,104584
Iran,IRN,2006,0,1964,8839,0,0,0,10803
Iran,IRN,2007,0,1659,0,1659,0,0,3318
Iran,IRN,2008,0,3001,818,3819,0,0,7638
Iran,IRN,2012,0,905,40349,0,0,0,41254
Iran,IRN,2014,0,4627,125,0,0,0,4752
Iran,IRN,2015,0,6358,0,0,0,0,6358
Iran,IRN,2017,0,7100,53133,0,0,0,60233
Iran,IRN,2018,0,1051,234,0,0,0,1285
Iran,IRN,2019,0,8780,809,0,0,0,9589
Iran,IRN,2020,0,4582,0,0,0,1375,5957
Iran,IRN,2022,0,11067,565,0,0,0,11632
Iran,IRN,1903,0,0,335613,0,0,0,335613
Iran,IRN,1909,0,0,4549571,0,0,0,4549571
Iran,IRN,1911,0,0,643243,0,0,0,643243
Iran,IRN,1923,0,0,2611639,0,0,0,2611639
Iran,IRN,1925,0,0,461289,0,0,0,461289
Iran,IRN,1929,0,0,2633016,0,0,0,2633016
Iran,IRN,1930,0,0,1071599,0,0,0,1071599
Iran,IRN,1932,0,0,806562,0,0,0,806562
Iran,IRN,1935,0,0,536408,0,0,0,536408
Iran,IRN,1936,0,0,8434,0,0,0,8434
Iran,IRN,1941,0,0,475135,0,0,0,475135
Iran,IRN,1944,0,0,12662,0,0,0,12662
Iran,IRN,1945,0,0,12552,0,0,0,12552
Iran,IRN,1947,0,0,246737,0,0,0,246737
Iran,IRN,1948,0,0,122304,0,0,0,122304
Iran,IRN,1958,0,0,94111,0,0,0,94111
Iran,IRN,1960,0,0,224416,0,0,0,224416
Iran,IRN,1961,0,0,27293,0,0,0,27293
Iran,IRN,1962,0,0,5308548,0,0,0,5308548
Iran,IRN,1965,0,0,8108,0,0,0,8108
Iran,IRN,1970,0,0,61864,0,0,15114,76978
Iran,IRN,1972,0,0,1679421,19926,0,0,1699347
Iran,IRN,1976,0,0,4728,0,0,0,4728
Iran,IRN,1977,0,0,319413,0,0,0,319413
Iran,IRN,1978,0,0,6958169,0,0,0,6958169
Iran,IRN,1979,0,0,151861,0,0,0,151861
Iran,IRN,1983,0,0,7495,0,0,0,7495
Iran,IRN,1985,0,0,212,0,0,0,212
Iran,IRN,2009,0,0,0,0,0,0,0
Iran,IRN,2010,0,0,1459,0,0,0,1459
Iran,IRN,2013,0,0,5735,0,0,0,5735
Iran,IRN,2023,0,0,336,0,0,0,336
Iran,IRN,1975,0,0,0,4261,0,0,4261
Iran,IRN,2016,0,0,0,480,0,0,480
Iraq,IRQ,1969,0,0,0,0,0,0,0
Iraq,IRQ,1998,0,0,0,0,0,0,0
Iraq,IRQ,2021,0,3675,0,0,0,0,3675
Iraq,IRQ,1954,0,0,0,0,0,0,0
Iraq,IRQ,1967,0,0,0,0,0,0,0
Iraq,IRQ,1968,0,0,0,0,0,0,0
Iraq,IRQ,2004,0,0,0,0,0,0,0
Iraq,IRQ,2006,0,6919,0,0,0,0,6919
Iraq,IRQ,2008,0,1369,0,0,0,0,1369
Iraq,IRQ,2009,0,660,0,0,0,0,660
Iraq,IRQ,2011,0,1853,0,0,0,0,1853
Iraq,IRQ,2012,0,1181,0,0,0,0,1181
Iraq,IRQ,2013,0,3100,0,0,0,0,3100
Iraq,IRQ,2015,0,15361,0,0,0,0,15361
Iraq,IRQ,2018,0,5174,0,0,0,0,5174
Iraq,IRQ,2019,0,2406,0,0,0,0,2406
Iraq,IRQ,2020,0,1880,0,0,0,0,1880
Iraq,IRQ,1991,0,0,11207,0,0,0,11207
Iraq,IRQ,2017,0,0,2524,0,0,0,2524
Iraq,IRQ,2022,0,0,0,225,0,0,225
Ireland,IRL,1987,0,0,0,0,0,0,0
Ireland,IRL,1993,0,8461,0,0,0,0,8461
Ireland,IRL,2002,0,0,0,0,0,0,0
Ireland,IRL,2009,0,0,0,0,0,0,0
Ireland,IRL,2011,0,4401,0,0,0,0,4401
Ireland,IRL,2017,0,0,0,0,0,0,0
Ireland,IRL,1983,0,0,0,28794,0,0,28794
Ireland,IRL,1986,0,0,0,31288,0,0,31288
Ireland,IRL,1990,0,0,0,5738,0,0,5738
Ireland,IRL,1991,0,0,0,0,0,0,0
Ireland,IRL,1996,0,0,0,5545,0,0,5545
Ireland,IRL,1998,0,0,0,5437,0,0,5437
Ireland,IRL,1999,0,0,0,21506,0,0,21506
Ireland,IRL,2000,0,0,0,2653,0,0,2653
Ireland,IRL,2004,0,0,0,0,0,0,0
Ireland,IRL,2005,0,0,0,0,0,0,0
Ireland,IRL,2014,0,0,0,2163,0,0,2163
Ireland,IRL,2015,0,0,0,2143,0,0,2143
Ireland,IRL,2018,0,0,0,4137,0,0,4137
Ireland,IRL,2020,0,0,0,0,0,0,0
Ireland,IRL,2022,0,0,0,1991,51761,0,53752
Isle of Man,IMN,2020,0,0,0,0,0,0,0
Israel,ISR,1999,0,0,0,0,0,0,0
Israel,ISR,1997,0,26117,0,0,0,0,26117
Israel,ISR,1998,0,0,0,0,0,0,0
Israel,ISR,2010,0,2729,0,0,0,60040,62769
Israel,ISR,2018,0,14190,0,0,0,0,14190
Israel,ISR,2020,0,7993,0,0,0,0,7993
Israel,ISR,1903,0,0,534722,0,0,0,534722
Israel,ISR,1991,0,0,0,10116,0,0,10116
Israel,ISR,2000,0,0,0,4904,0,0,4904
Israel,ISR,2013,0,0,0,5177,0,0,5177
Israel,ISR,2015,0,0,0,0,0,0,0
Israel,ISR,1992,0,0,0,0,0,0,0
Israel,ISR,1970,0,0,0,0,0,68792,68792
Israel,ISR,1983,0,0,0,0,0,0,0
Israel,ISR,1995,0,0,0,0,0,0,0
Israel,ISR,2016,0,0,0,0,0,0,0
Italy,ITA,1997,0,0,2459,3865,0,0,6324
Italy,ITA,2002,0,350,5603,0,0,0,5953
Italy,ITA,2012,0,665,3987,0,7476,0,12128
Italy,ITA,2017,0,0,5166,2167,0,0,7333
Italy,ITA,2022,0,0,0,339,3050605,3896,3054840
Italy,ITA,1939,0,2311,0,0,0,0,2311
Italy,ITA,1951,0,34866,0,0,0,0,34866
Italy,ITA,1953,0,21092,0,0,0,0,21092
Italy,ITA,1965,0,10689,0,7191,0,0,17880
Italy,ITA,1966,0,13492,0,0,0,0,13492
Italy,ITA,1968,0,13672,42536,0,0,0,56208
Italy,ITA,1970,0,6939,0,6564,0,0,13503
Italy,ITA,1977,0,4133,0,0,0,0,4133
Italy,ITA,1985,0,58090,0,0,0,0,58090
Italy,ITA,1986,0,353,0,0,0,0,353
Italy,ITA,1987,0,0,0,5826,0,10063,15889
Italy,ITA,1992,0,352,0,0,0,0,352
Italy,ITA,1994,0,11954,0,527,0,176,12657
Italy,ITA,1996,0,2988,0,0,0,0,2988
Italy,ITA,2000,0,8075,0,0,0,0,8075
Italy,ITA,2001,0,351,0,0,0,0,351
Italy,ITA,2003,0,522,0,0,3498291,0,3498813
Italy,ITA,2008,0,1520,0,0,0,0,1520
Italy,ITA,2009,0,5876,49528,504,0,336,56244
Italy,ITA,2010,0,0,0,501,0,0,501
Italy,ITA,2011,0,2666,0,0,1666,500,4832
Italy,ITA,2013,0,2984,0,0,0,0,2984
Italy,ITA,2014,0,1658,0,829,0,0,2487
Italy,ITA,2015,0,996,0,498,0,0,1494
Italy,ITA,2016,0,333,49402,0,0,0,49735
Italy,ITA,2018,0,1670,0,2004,167,0,3841
Italy,ITA,2019,0,0,0,335,502,0,837
Italy,ITA,2020,0,840,0,1849,0,504,3193
Italy,ITA,2021,0,169,0,0,0,0,169
Italy,ITA,2023,0,2888,0,340,0,170,3398
Italy,ITA,1905,0,0,160741,0,0,0,160741
Italy,ITA,1908,0,0,21128674,0,0,0,21128674
Italy,ITA,1914,0,0,33004,0,0,0,33004
Italy,ITA,1915,0,0,8229079,0,0,0,8229079
Italy,ITA,1920,0,0,378710,0,0,0,378710
Italy,ITA,1930,0,0,473366,0,0,0,473366
Italy,ITA,1933,0,0,2428,0,0,0,2428
Italy,ITA,1962,0,0,3190,0,0,0,3190
Italy,ITA,1971,0,0,4102,0,0,0,4102
Italy,ITA,1972,0,0,556,0,0,0,556
Italy,ITA,1976,0,0,170612,0,0,0,170612
Italy,ITA,1978,0,0,895,179,0,0,1074
Italy,ITA,1979,0,0,892,0,0,1605,2497
Italy,ITA,1980,0,0,832424,0,0,0,832424
Italy,ITA,1981,0,0,2123,0,0,0,2123
Italy,ITA,1982,0,0,0,0,0,0,0
Italy,ITA,1983,0,0,0,0,0,1237,1237
Italy,ITA,1984,0,0,1236,0,0,0,1236
Italy,ITA,1990,0,0,3700,1057,0,0,4757
Italy,ITA,1998,0,0,0,0,1756,28100,29856
Italy,ITA,1948,0,0,0,17457,0,5455,22912
Italy,ITA,1973,0,0,0,6988,0,0,6988
Italy,ITA,1993,0,0,0,1407,0,0,1407
Italy,ITA,2004,0,0,0,346,0,0,346
Italy,ITA,2006,0,0,0,171,0,685,856
Italy,ITA,2005,0,0,0,0,1546,0,1546
Italy,ITA,2007,0,0,0,0,1021,1871,2892
Italy,ITA,1906,0,0,0,0,0,200393,200393
Italy,ITA,1944,0,0,0,0,0,5813,5813
Italy,ITA,1991,0,0,0,0,0,0,0
Italy,ITA,1922,0,0,0,0,0,26687,26687
Italy,ITA,1954,0,0,0,0,0,62090,62090
Italy,ITA,1960,0,0,0,0,0,2423,2423
Italy,ITA,1963,0,0,0,0,0,379190,379190
Italy,ITA,1975,0,0,0,0,0,2178,2178
Italy,ITA,1999,0,0,0,0,0,176,176
Jamaica,JAM,1968,0,0,0,0,0,0,0
Jamaica,JAM,1981,0,0,0,0,0,0,0
Jamaica,JAM,2000,0,0,0,0,0,0,0
Jamaica,JAM,2014,0,0,0,0,0,0,0
Jamaica,JAM,1900,0,4122714,0,0,0,0,4122714
Jamaica,JAM,1933,0,489930,0,92440,0,0,582370
Jamaica,JAM,1937,0,953535,0,0,0,343616,1297151
Jamaica,JAM,1940,0,1019495,0,0,0,0,1019495
Jamaica,JAM,1979,0,208834,0,0,0,0,208834
Jamaica,JAM,1986,0,233173,0,0,0,0,233173
Jamaica,JAM,1987,0,38523,0,0,0,0,38523
Jamaica,JAM,1988,0,0,0,208084,0,0,208084
Jamaica,JAM,1991,0,62192,0,0,0,0,62192
Jamaica,JAM,1993,0,36599,0,0,0,0,36599
Jamaica,JAM,2002,0,34114,0,15162,0,0,49276
Jamaica,JAM,2006,0,3718,0,0,0,0,3718
Jamaica,JAM,1907,0,0,15185799,0,0,0,15185799
Jamaica,JAM,1903,0,0,0,862126,0,0,862126
Jamaica,JAM,1912,0,0,0,1714715,0,0,1714715
Jamaica,JAM,1917,0,0,0,668405,0,0,668405
Jamaica,JAM,1923,0,0,0,43871,0,0,43871
Jamaica,JAM,1935,0,0,0,0,0,0,0
Jamaica,JAM,1944,0,0,0,246733,0,0,246733
Jamaica,JAM,1951,0,0,0,1063239,0,0,1063239
Jamaica,JAM,1963,0,0,0,64559,0,0,64559
Jamaica,JAM,1973,0,0,0,30843,0,0,30843
Jamaica,JAM,1980,0,0,0,28096,0,0,28096
Jamaica,JAM,1985,0,0,0,30541,0,0,30541
Jamaica,JAM,1994,0,0,0,16102,0,0,16102
Jamaica,JAM,1996,0,0,0,0,0,0,0
Jamaica,JAM,2001,0,0,0,3809,0,0,3809
Jamaica,JAM,2004,0,0,0,60059,0,0,60059
Jamaica,JAM,2005,0,0,0,22414,0,0,22414
Jamaica,JAM,2007,0,0,0,18510,0,0,18510
Jamaica,JAM,2008,0,0,0,47946,0,0,47946
Jamaica,JAM,2010,0,0,0,54867,0,0,54867
Jamaica,JAM,2012,0,0,0,3623,0,0,3623
Jamaica,JAM,2016,0,0,0,0,0,0,0
Jamaica,JAM,2017,0,0,0,0,0,0,0
Jamaica,JAM,1909,0,0,0,0,0,655923,655923
Japan,JPN,1977,0,436,0,2788,0,261,3485
Japan,JPN,1910,0,276462,0,0,0,0,276462
Japan,JPN,1938,0,130151,0,0,0,0,130151
Japan,JPN,1943,0,129131,182609,0,0,0,311740
Japan,JPN,1947,0,246813,0,238174,0,0,484987
Japan,JPN,1950,0,15056,0,60342,0,0,75398
Japan,JPN,1951,0,35713,0,110056,0,0,145769
Japan,JPN,1953,0,450503,0,31684,0,0,482187
Japan,JPN,1957,0,108017,0,11869,0,0,119886
Japan,JPN,1959,0,4381,0,562538,0,0,566919
Japan,JPN,1961,0,37439,1049,31042,0,0,69530
Japan,JPN,1962,0,7375,0,0,0,0,7375
Japan,JPN,1964,0,13832,2543,4272,0,10985,31632
Japan,JPN,1965,0,14276,0,14779,0,0,29055
Japan,JPN,1967,0,48164,0,28564,0,0,76728
Japan,JPN,1972,0,42321,0,4620,0,7392,54333
Japan,JPN,1976,0,0,0,14874,0,0,14874
Japan,JPN,1978,0,691,4576,518,0,0,5785
Japan,JPN,1979,0,1970,0,6081,0,0,8051
Japan,JPN,1980,0,1700,170,595,0,0,2465
Japan,JPN,1982,0,28968,9236,18304,0,0,56508
Japan,JPN,1986,0,1150,0,1397,0,2711,5258
Japan,JPN,1988,0,2199,0,0,0,0,2199
Japan,JPN,1989,0,811,0,1217,0,1460,3488
Japan,JPN,1990,0,2183,0,3234,0,0,5417
Japan,JPN,1993,0,0,19314,9056,0,6732,35102
Japan,JPN,1995,0,0,422294,239,0,0,422533
Japan,JPN,1998,0,1267,0,3246,0,0,4513
Japan,JPN,1999,0,4741,0,2054,0,0,6795
Japan,JPN,2000,0,1420,79,1025,0,0,2524
Japan,JPN,2001,0,79,157,1731,0,0,1967
Japan,JPN,2003,0,1804,157,1647,0,0,3608
Japan,JPN,2004,0,1723,3133,15587,783,0,21226
Japan,JPN,2005,0,0,78,10564,0,0,10642
Japan,JPN,2006,0,3284,0,1564,0,0,4848
Japan,JPN,2007,0,156,781,1016,4844,0,6797
Japan,JPN,2008,0,390,1874,0,3670,0,5934
Japan,JPN,2010,0,781,0,0,13270,0,14051
Japan,JPN,2011,0,469,1550537,6718,2812,0,1560536
Japan,JPN,2012,0,2346,0,11185,0,0,13531
Japan,JPN,2013,0,392,0,4464,26473,0,31329
Japan,JPN,2015,0,1650,0,864,3065,0,5579
Japan,JPN,2016,0,551,4567,1969,866,0,7953
Japan,JPN,2017,0,2921,0,947,0,0,3868
Japan,JPN,2018,0,19484,3643,1901,9425,0,34453
Japan,JPN,2019,0,1033,0,8109,13753,0,22895
Japan,JPN,2020,0,6547,0,160,0,0,6707
Japan,JPN,2021,0,963,80,1846,0,2086,4975
Japan,JPN,2022,0,161,242,2178,6454,0,9035
Japan,JPN,2023,0,487,81,406,0,0,974
Japan,JPN,1901,0,0,4009,0,0,0,4009
Japan,JPN,1905,0,0,11055,0,0,0,11055
Japan,JPN,1909,0,0,8318,0,0,0,8318
Japan,JPN,1911,0,0,2377,0,0,0,2377
Japan,JPN,1914,0,0,17960,0,0,26748,44708
Japan,JPN,1922,0,0,4667,0,0,0,4667
Japan,JPN,1923,0,0,24371939,511299,0,34087,24917325
Japan,JPN,1925,0,0,65463,0,0,0,65463
Japan,JPN,1927,0,0,487008,0,0,0,487008
Japan,JPN,1930,0,0,40052,0,0,0,40052
Japan,JPN,1933,0,0,446140,0,0,0,446140
Japan,JPN,1939,0,0,3718,0,0,0,3718
Japan,JPN,1944,0,0,157328,0,0,0,157328
Japan,JPN,1945,0,0,292567,532482,0,0,825049
Japan,JPN,1946,0,0,250254,0,0,0,250254
Japan,JPN,1948,0,0,624490,105644,0,0,730134
Japan,JPN,1952,0,0,3797,20248,0,3336,27381
Japan,JPN,1960,0,0,14609,4340,0,0,18949
Japan,JPN,1968,0,0,4571,12060,0,0,16631
Japan,JPN,1973,0,0,0,9209,0,0,9209
Japan,JPN,1974,0,0,2700,25563,0,1530,29793
Japan,JPN,1983,0,0,8598,14608,0,15610,38816
Japan,JPN,1984,0,0,1660,0,0,1162,2822
Japan,JPN,1987,0,0,164,654,0,0,818
Japan,JPN,1992,0,0,0,884,0,0,884
Japan,JPN,1994,0,0,559,240,0,0,799
Japan,JPN,2009,0,0,78,1249,1249,3434,6010
Japan,JPN,2014,0,0,0,10119,2118,11375,23612
Japan,JPN,1912,0,0,0,195735,0,0,195735
Japan,JPN,1917,0,0,0,737012,0,0,737012
Japan,JPN,1934,0,0,0,441349,0,0,441349
Japan,JPN,1949,0,0,0,74096,0,0,74096
Japan,JPN,1954,0,0,0,252882,0,0,252882
Japan,JPN,1955,0,0,0,29970,0,8103,38073
Japan,JPN,1956,0,0,0,9888,0,4395,14283
Japan,JPN,1958,0,0,0,210421,0,0,210421
Japan,JPN,1963,0,0,0,13677,0,0,13677
Japan,JPN,1966,0,0,0,35634,0,0,35634
Japan,JPN,1969,0,0,0,6916,0,0,6916
Japan,JPN,1971,0,0,0,12642,0,0,12642
Japan,JPN,1975,0,0,0,6049,0,2669,8718
Japan,JPN,1981,0,0,0,13769,0,3379,17148
Japan,JPN,1985,0,0,0,4046,0,0,4046
Japan,JPN,1991,0,0,0,8140,0,3466,11606
Japan,JPN,1996,0,0,0,477,0,1114,1591
Japan,JPN,1997,0,0,0,555,0,1666,2221
Japan,JPN,2002,0,0,0,550,0,0,550
Japan,JPN,1900,0,0,0,0,0,6754,6754
Japan,JPN,1902,0,0,0,0,0,27525,27525
Japan,JPN,1926,0,0,0,0,0,23533,23533
Jordan,JOR,1999,0,0,0,0,0,0,0
Jordan,JOR,2000,0,0,0,17800,0,0,17800
Jordan,JOR,1963,0,255465,0,0,0,0,255465
Jordan,JOR,1965,0,73161,0,0,0,0,73161
Jordan,JOR,1966,0,2208437,0,0,0,0,2208437
Jordan,JOR,1987,0,29854,0,0,0,0,29854
Jordan,JOR,1991,0,21820,0,5455,0,0,27275
Jordan,JOR,1997,0,4225,0,0,0,0,4225
Jordan,JOR,2018,0,32505,0,0,0,0,32505
Jordan,JOR,1927,0,0,12100415,0,0,0,12100415
Jordan,JOR,2002,0,0,0,9478,0,0,9478
Jordan,JOR,1992,0,0,0,0,38791,0,38791
Kazakhstan,KAZ,2021,0,0,0,0,0,0,0
Kazakhstan,KAZ,1993,0,5889,0,0,0,0,5889
Kazakhstan,KAZ,2000,0,0,0,0,0,0,0
Kazakhstan,KAZ,2001,0,0,0,0,1963,0,1963
Kazakhstan,KAZ,2005,0,0,0,0,0,0,0
Kazakhstan,KAZ,2008,0,617,0,0,0,0,617
Kazakhstan,KAZ,2010,0,26462,0,0,0,0,26462
Kazakhstan,KAZ,2011,0,1186,0,0,0,0,1186
Kazakhstan,KAZ,2012,0,0,0,0,0,0,0
Kazakhstan,KAZ,2014,0,2842,0,0,0,0,2842
Kazakhstan,KAZ,2015,0,1121,0,0,0,0,1121
Kazakhstan,KAZ,2017,0,0,0,0,0,0,0
Kazakhstan,KAZ,2018,0,0,0,0,0,0,0
Kazakhstan,KAZ,2020,0,0,0,0,0,0,0
Kazakhstan,KAZ,1911,0,0,981875,0,0,0,981875
Kazakhstan,KAZ,2003,0,0,1946,0,0,0,1946
Kazakhstan,KAZ,1995,0,0,0,68150,0,0,68150
Kazakhstan,KAZ,1997,0,0,0,0,0,0,0
Kazakhstan,KAZ,2004,0,0,0,0,0,30924,30924
Kazakhstan,KAZ,2023,0,0,0,0,0,7140,7140
Kenya,KEN,1965,0,0,0,0,0,0,0
Kenya,KEN,1971,0,0,0,0,0,0,0
Kenya,KEN,1979,0,0,0,0,0,0,0
Kenya,KEN,1983,0,0,0,0,0,0,0
Kenya,KEN,1991,0,0,0,0,0,0,0
Kenya,KEN,1994,0,0,0,0,0,0,0
Kenya,KEN,1996,0,0,0,0,0,0,0
Kenya,KEN,1999,28366,0,0,0,0,0,28366
Kenya,KEN,2004,22994,15521,287,0,0,0,38802
Kenya,KEN,2005,7533,7254,0,0,0,0,14787
Kenya,KEN,2008,1021,14035,0,0,0,2552,17608
Kenya,KEN,2010,0,46727,0,0,0,2409,49136
Kenya,KEN,2011,0,7740,0,0,0,0,7740
Kenya,KEN,2014,0,0,0,0,0,0,0
Kenya,KEN,2016,0,8769,0,0,0,0,8769
Kenya,KEN,2019,0,17664,0,0,0,19038,36702
Kenya,KEN,2020,0,54823,0,0,0,0,54823
Kenya,KEN,1964,0,0,0,0,0,0,0
Kenya,KEN,1968,0,0,0,0,0,0,0
Kenya,KEN,1975,0,0,0,0,0,0,0
Kenya,KEN,1977,0,68600,0,0,0,0,68600
Kenya,KEN,1982,0,43075,0,0,0,0,43075
Kenya,KEN,1990,0,18996,0,0,0,0,18996
Kenya,KEN,1997,0,30320,0,0,0,0,30320
Kenya,KEN,1998,0,13728,0,0,0,0,13728
Kenya,KEN,2001,0,1258,0,0,0,0,1258
Kenya,KEN,2002,0,25931,0,0,0,4881,30812
Kenya,KEN,2003,0,11846,0,0,0,0,11846
Kenya,KEN,2006,0,57413,0,0,0,0,57413
Kenya,KEN,2007,0,4995,0,0,0,5258,10253
Kenya,KEN,2009,0,13874,0,0,0,0,13874
Kenya,KEN,2012,0,16695,0,0,0,0,16695
Kenya,KEN,2013,0,28576,0,0,0,0,28576
Kenya,KEN,2015,0,29455,0,0,0,0,29455
Kenya,KEN,2017,0,5312,0,0,0,0,5312
Kenya,KEN,2018,0,26825,0,0,0,0,26825
Kenya,KEN,2021,0,1698,0,0,0,0,1698
Kenya,KEN,2023,0,4537,0,0,0,0,4537
Kenya,KEN,1988,0,0,0,23120,0,0,23120
Kiribati,KIR,1999,0,0,0,0,0,0,0
Kiribati,KIR,2008,0,0,0,0,0,0,0
Kiribati,KIR,2014,0,0,0,0,0,0,0
Kiribati,KIR,1972,0,0,0,503119,0,0,503119
Kiribati,KIR,2015,0,0,0,0,0,0,0
Kuwait,KWT,1997,0,11354,0,0,0,0,11354
Kuwait,KWT,2018,0,2316,0,0,0,0,2316
Kyrgyzstan,KGZ,2009,0,0,0,0,0,0,0
Kyrgyzstan,KGZ,1998,0,2079,0,0,0,0,2079
Kyrgyzstan,KGZ,2005,0,5777,0,0,0,0,5777
Kyrgyzstan,KGZ,2007,0,0,0,0,0,0,0
Kyrgyzstan,KGZ,2012,0,0,0,0,28409,0,28409
Kyrgyzstan,KGZ,1992,0,0,128853,0,0,0,128853
Kyrgyzstan,KGZ,1997,0,0,0,0,0,0,0
Kyrgyzstan,KGZ,2006,0,0,0,7624,0,0,7624
Kyrgyzstan,KGZ,2008,0,0,138436,0,0,0,138436
Kyrgyzstan,KGZ,2011,0,0,0,0,0,0,0
Kyrgyzstan,KGZ,2015,0,0,0,0,0,0,0
Kyrgyzstan,KGZ,2017,0,0,0,0,0,39208,39208
Kyrgyzstan,KGZ,2014,0,0,0,0,0,0,0
Kyrgyzstan,KGZ,2000,0,0,0,0,22289,0,22289
Kyrgyzstan,KGZ,2022,0,0,0,0,0,0,0
Kyrgyzstan,KGZ,1994,0,0,0,0,0,357545,357545
Kyrgyzstan,KGZ,2002,0,0,0,0,0,0,0
Kyrgyzstan,KGZ,2003,0,0,0,0,0,74829,74829
Kyrgyzstan,KGZ,2004,0,0,0,0,0,95386,95386
Kyrgyzstan,KGZ,2010,0,0,0,0,0,0,0
Kyrgyzstan,KGZ,2021,0,0,0,0,0,22979,22979
Laos,LAO,1977,0,0,0,0,0,0,0
Laos,LAO,1987,0,0,0,0,0,0,0
Laos,LAO,1988,0,0,0,0,0,0,0
Laos,LAO,1991,0,0,0,0,0,0,0
Laos,LAO,1999,0,0,0,0,0,0,0
Laos,LAO,2019,0,26345,0,0,0,0,26345
Laos,LAO,1966,0,1232100,0,0,0,0,1232100
Laos,LAO,1968,0,7840,0,0,0,0,7840
Laos,LAO,1969,0,0,0,0,0,0,0
Laos,LAO,1971,0,51081,0,0,0,0,51081
Laos,LAO,1978,0,97547,0,0,0,0,97547
Laos,LAO,1981,0,0,0,0,0,0,0
Laos,LAO,1984,0,38462,0,0,0,0,38462
Laos,LAO,1992,0,21924,0,48234,0,0,70158
Laos,LAO,1994,0,0,0,0,0,0,0
Laos,LAO,1995,0,0,0,52766,0,0,52766
Laos,LAO,1996,0,59478,0,0,0,0,59478
Laos,LAO,2000,0,27620,0,0,0,0,27620
Laos,LAO,2001,0,0,0,0,0,0,0
Laos,LAO,2002,0,3568,0,0,0,0,3568
Laos,LAO,2008,0,9779,0,0,0,0,9779
Laos,LAO,2009,0,16052,0,25682,0,0,41734
Laos,LAO,2011,0,74809,0,0,0,0,74809
Laos,LAO,2013,0,34845,0,0,0,0,34845
Laos,LAO,2014,0,0,0,0,0,0,0
Laos,LAO,2015,0,5893,0,0,0,0,5893
Laos,LAO,2016,0,7255,0,0,0,0,7255
Laos,LAO,2018,0,191414,0,0,0,0,191414
Laos,LAO,2022,0,1328,0,0,0,0,1328
Laos,LAO,2021,0,0,0,0,0,0,0
Laos,LAO,1993,0,0,0,17075,0,0,17075
Laos,LAO,2017,0,0,0,0,0,0,0
Laos,LAO,2020,0,0,0,2732,0,0,2732
Latvia,LVA,2023,0,0,0,0,0,0,0
Latvia,LVA,1999,0,0,0,24728,0,0,24728
Latvia,LVA,2005,0,0,0,0,179118,0,179118
Latvia,LVA,2001,0,0,0,0,89011,0,89011
Latvia,LVA,2003,0,0,0,0,65378,0,65378
Latvia,LVA,2012,0,0,0,0,48694,0,48694
Latvia,LVA,2022,0,0,0,0,567367,0,567367
Latvia,LVA,2018,0,0,0,0,0,0,0
Lebanon,LBN,1955,0,2827160,0,0,0,0,2827160
Lebanon,LBN,1987,0,0,0,0,0,0,0
Lebanon,LBN,2003,0,0,0,0,0,0,0
Lebanon,LBN,1956,0,0,849014,0,0,0,849014
Lebanon,LBN,1992,0,0,0,66748,0,0,66748
Lebanon,LBN,2002,0,0,0,0,0,0,0
Lebanon,LBN,2015,0,0,0,7814,0,0,7814
Lebanon,LBN,2018,0,0,0,25207,0,0,25207
Lebanon,LBN,2019,0,0,0,5189,0,0,5189
Lebanon,LBN,2023,0,0,0,0,0,0,0
Lebanon,LBN,2007,0,0,0,0,0,2079,2079
Lebanon,LBN,2020,0,0,0,0,0,0,0
Lebanon,LBN,1983,0,0,0,0,0,64371,64371
Lesotho,LSO,1968,0,0,0,0,0,0,0
Lesotho,LSO,1983,0,0,0,0,0,0,0
Lesotho,LSO,1990,0,122290,0,0,0,0,122290
Lesotho,LSO,2002,0,0,0,0,0,0,0
Lesotho,LSO,2007,0,0,0,0,0,0,0
Lesotho,LSO,2011,0,127596,0,0,0,0,127596
Lesotho,LSO,2016,0,0,0,0,0,0,0
Lesotho,LSO,2019,0,0,0,0,0,0,0
Lesotho,LSO,2020,0,0,0,0,0,0,0
Lesotho,LSO,1985,0,0,0,0,0,0,0
Lesotho,LSO,1987,0,105948,0,0,0,0,105948
Lesotho,LSO,1989,0,0,0,0,0,0,0
Lesotho,LSO,1996,0,0,0,0,0,0,0
Lesotho,LSO,2001,0,0,0,5001,0,0,5001
Lesotho,LSO,2008,0,0,0,0,0,0,0
Lesotho,LSO,2014,0,0,0,0,0,0,0
Lesotho,LSO,2021,0,0,0,0,0,0,0
Liberia,LBR,1980,0,0,0,0,0,0,0
Liberia,LBR,1998,0,37890,0,0,0,0,37890
Liberia,LBR,2007,0,2753,0,0,0,0,2753
Liberia,LBR,2008,0,0,0,0,0,0,0
Liberia,LBR,2009,0,5122,0,0,0,0,5122
Liberia,LBR,2010,0,2488,0,0,0,0,2488
Liberia,LBR,2016,0,0,0,0,0,0,0
Liberia,LBR,1995,0,0,0,0,0,0,0
Liberia,LBR,1990,0,0,0,0,0,0,0
Liberia,LBR,1982,0,0,0,0,0,224652,224652
Libya,LBY,1995,0,0,0,0,0,0,0
Libya,LBY,2013,0,26732,0,0,0,0,26732
Libya,LBY,2019,0,6089,0,0,0,0,6089
Libya,LBY,1963,0,0,1881153,0,0,0,1881153
Lithuania,LTU,1992,0,0,0,0,0,0,0
Lithuania,LTU,2006,0,0,0,0,0,0,0
Lithuania,LTU,2018,0,0,0,0,17384,0,17384
Lithuania,LTU,2005,0,0,0,0,0,0,0
Lithuania,LTU,2010,0,12743,0,0,15929,0,28672
Lithuania,LTU,1993,0,0,0,15837,0,0,15837
Lithuania,LTU,1999,0,0,0,5504,88058,0,93562
Lithuania,LTU,2001,0,0,0,0,56177,0,56177
Lithuania,LTU,2012,0,0,0,0,97932,0,97932
Lithuania,LTU,2022,0,0,0,0,1385425,0,1385425
Luxembourg,LUX,1983,0,0,0,0,0,0,0
Luxembourg,LUX,1993,0,0,0,0,0,0,0
Luxembourg,LUX,2021,0,0,0,0,0,0,0
Luxembourg,LUX,1990,0,0,0,0,0,0,0
Luxembourg,LUX,1995,0,0,0,0,0,0,0
Luxembourg,LUX,2010,0,0,0,0,0,0,0
Luxembourg,LUX,2019,0,0,0,0,0,0,0
Luxembourg,LUX,2003,0,0,0,0,3766470,0,3766470
Luxembourg,LUX,2022,0,0,0,0,679431,0,679431
Macau,MAC,1993,0,0,0,0,0,0,0
Macau,MAC,2017,0,0,0,156590,0,0,156590
Macedonia [FYROM],MKD,1993,0,0,0,0,0,0,0
Macedonia [FYROM],MKD,1995,0,0,0,0,0,0,0
Macedonia [FYROM],MKD,2002,0,0,0,0,0,0,0
Macedonia [FYROM],MKD,2003,0,9656,0,0,0,0,9656
Macedonia [FYROM],MKD,2004,0,0,0,0,72259,0,72259
Macedonia [FYROM],MKD,2005,0,0,0,4811,0,0,4811
Macedonia [FYROM],MKD,2006,0,0,0,0,0,0,0
Macedonia [FYROM],MKD,2013,0,4757,0,0,0,0,4757
Macedonia [FYROM],MKD,2015,0,33207,0,0,0,0,33207
Macedonia [FYROM],MKD,2016,0,104256,0,0,0,0,104256
Macedonia [FYROM],MKD,2001,0,0,0,0,73050,0,73050
Macedonia [FYROM],MKD,2007,0,0,0,0,0,4800,4800
Macedonia [FYROM],MKD,2012,0,0,0,0,4763,0,4763
Macedonia [FYROM],MKD,2014,0,0,0,0,0,0,0
Macedonia [FYROM],MKD,2017,0,0,0,0,14205,0,14205
Macedonia [FYROM],MKD,2000,0,0,0,0,0,0,0
Macedonia [FYROM],MKD,2021,0,0,0,0,0,4754,4754
Madagascar,MDG,1981,0,0,0,116212,0,0,116212
Madagascar,MDG,1988,178463,0,0,0,0,0,178463
Madagascar,MDG,2000,0,0,0,94349,0,0,94349
Madagascar,MDG,2002,0,0,0,13363,0,0,13363
Madagascar,MDG,2005,0,15432,0,41507,0,0,56939
Madagascar,MDG,2008,0,0,0,51186,0,0,51186
Madagascar,MDG,2014,0,0,0,7020,0,0,7020
Madagascar,MDG,2016,0,0,0,0,0,0,0
Madagascar,MDG,2017,0,0,0,30952,0,0,30952
Madagascar,MDG,2020,0,14172,0,1417,0,0,15589
Madagascar,MDG,1986,0,0,0,93498,0,0,93498
Madagascar,MDG,1998,0,0,0,0,0,0,0
Madagascar,MDG,2003,0,9027,0,50214,0,0,59241
Madagascar,MDG,2007,0,3513,0,42158,0,0,45671
Madagascar,MDG,2015,0,10462,0,38228,0,0,48690
Madagascar,MDG,2019,0,3269,0,2906,0,0,6175
Madagascar,MDG,2021,0,346,0,692,0,0,1038
Madagascar,MDG,2022,0,11482,0,64164,0,0,75646
Madagascar,MDG,1968,0,0,0,46248,0,0,46248
Madagascar,MDG,1969,0,0,0,125575,0,0,125575
Madagascar,MDG,1970,0,0,0,105426,0,0,105426
Madagascar,MDG,1972,0,0,0,129058,0,0,129058
Madagascar,MDG,1975,0,0,0,9066,0,0,9066
Madagascar,MDG,1976,0,0,0,20113,0,0,20113
Madagascar,MDG,1977,0,0,0,12202,0,0,12202
Madagascar,MDG,1978,0,0,0,82929,0,0,82929
Madagascar,MDG,1982,0,0,0,97139,0,0,97139
Madagascar,MDG,1983,0,0,0,43121,0,0,43121
Madagascar,MDG,1984,0,0,0,67898,0,0,67898
Madagascar,MDG,1989,0,0,0,39873,0,0,39873
Madagascar,MDG,1991,0,0,0,29399,0,0,29399
Madagascar,MDG,1994,0,0,0,157784,0,0,157784
Madagascar,MDG,1996,0,0,0,6286,0,0,6286
Madagascar,MDG,1997,0,0,0,117735,0,0,117735
Madagascar,MDG,2004,0,0,0,216429,0,0,216429
Madagascar,MDG,2006,0,0,0,2067,0,0,2067
Madagascar,MDG,2009,0,0,0,12786,0,0,12786
Madagascar,MDG,2010,0,0,0,55221,0,0,55221
Madagascar,MDG,2011,0,0,0,15661,0,0,15661
Madagascar,MDG,2012,0,0,0,48767,0,0,48767
Madagascar,MDG,2013,0,0,0,21621,0,0,21621
Madagascar,MDG,2018,0,0,0,35014,0,0,35014
Madagascar,MDG,2023,0,0,0,24072,0,0,24072
Malawi,MWI,1987,0,0,0,0,0,0,0
Malawi,MWI,1990,0,0,0,0,0,0,0
Malawi,MWI,1992,0,0,0,0,0,0,0
Malawi,MWI,2002,424286,7637,0,0,0,0,431923
Malawi,MWI,2005,0,784,0,8624,0,0,9408
Malawi,MWI,2007,0,1482,0,0,0,0,1482
Malawi,MWI,2012,0,2567,0,0,0,0,2567
Malawi,MWI,2015,0,164119,0,2952,0,0,167071
Malawi,MWI,2022,0,30384,0,34795,0,0,65179
Malawi,MWI,1967,0,0,0,0,0,0,0
Malawi,MWI,1969,0,0,0,0,0,0,0
Malawi,MWI,1979,0,0,0,0,0,0,0
Malawi,MWI,1982,0,0,0,0,0,0,0
Malawi,MWI,1989,0,14169,9809,0,0,0,23978
Malawi,MWI,1991,0,480085,0,0,0,0,480085
Malawi,MWI,1995,0,989,0,0,0,0,989
Malawi,MWI,1997,0,0,0,0,0,0,0
Malawi,MWI,1998,0,3727,0,0,0,0,3727
Malawi,MWI,1999,0,0,0,0,0,0,0
Malawi,MWI,2000,0,0,0,0,0,0,0
Malawi,MWI,2001,0,51310,0,0,0,0,51310
Malawi,MWI,2003,0,9927,0,0,0,0,9927
Malawi,MWI,2006,0,6098,0,0,0,0,6098
Malawi,MWI,2008,0,0,0,0,0,0,0
Malawi,MWI,2010,0,0,0,0,0,0,0
Malawi,MWI,2011,0,2641,0,0,0,0,2641
Malawi,MWI,2013,0,1872,0,0,0,0,1872
Malawi,MWI,2016,0,6894,0,0,0,0,6894
Malawi,MWI,2017,0,0,0,0,0,0,0
Malawi,MWI,2018,0,2722,0,0,0,0,2722
Malawi,MWI,2019,0,31801,0,0,0,4240,36041
Malawi,MWI,2020,0,516,0,0,0,0,516
Malawi,MWI,2009,0,0,2797,0,0,0,2797
Malawi,MWI,2021,0,0,0,6536,0,0,6536
Malawi,MWI,2023,0,0,0,324388,0,0,324388
Malaysia,MYS,1998,0,0,0,0,0,0,0
Malaysia,MYS,2014,0,5554,0,0,0,0,5554
Malaysia,MYS,1965,0,6600,0,0,0,0,6600
Malaysia,MYS,1967,0,52181,0,0,0,0,52181
Malaysia,MYS,1970,0,59186,0,0,0,0,59186
Malaysia,MYS,1978,0,0,0,0,0,0,0
Malaysia,MYS,1983,0,6996,0,0,0,0,6996
Malaysia,MYS,1986,0,7070,0,0,0,0,7070
Malaysia,MYS,1987,0,1871,0,0,0,0,1871
Malaysia,MYS,1988,0,16339,0,0,0,0,16339
Malaysia,MYS,1993,0,15748,0,0,0,37795,53543
Malaysia,MYS,1996,0,0,0,130504,0,24167,154671
Malaysia,MYS,1999,0,447,0,0,0,0,447
Malaysia,MYS,2000,0,5230,0,0,0,0,5230
Malaysia,MYS,2001,0,4672,0,0,0,0,4672
Malaysia,MYS,2003,0,3234,0,0,0,0,3234
Malaysia,MYS,2004,0,6316,31579,395,0,0,38290
Malaysia,MYS,2005,0,5015,0,0,0,0,5015
Malaysia,MYS,2006,0,2263,0,0,0,0,2263
Malaysia,MYS,2007,0,16979,0,0,0,0,16979
Malaysia,MYS,2008,0,0,0,0,0,0,0
Malaysia,MYS,2009,0,0,0,0,0,0,0
Malaysia,MYS,2011,0,685,0,0,0,5482,6167
Malaysia,MYS,2013,0,1327,0,0,0,0,1327
Malaysia,MYS,2015,0,322,7725,0,0,0,8047
Malaysia,MYS,2016,0,0,0,0,0,0,0
Malaysia,MYS,2017,0,2815,0,0,0,0,2815
Malaysia,MYS,2018,0,617,0,0,0,0,617
Malaysia,MYS,2019,0,610,0,0,0,0,610
Malaysia,MYS,2020,0,0,0,0,0,0,0
Malaysia,MYS,2021,0,23530,0,0,0,0,23530
Malaysia,MYS,2022,0,5009,0,0,0,9724,14733
Malaysia,MYS,2023,0,1166,0,0,0,0,1166
Malaysia,MYS,1968,0,0,0,21382,0,0,21382
Malaysia,MYS,1997,0,0,0,941,0,0,941
Malaysia,MYS,2002,0,0,0,828,0,4142,4970
Malaysia,MYS,1995,0,0,0,0,0,9932,9932
Maldives,MDV,1987,0,0,0,0,0,0,0
Maldives,MDV,2007,0,0,0,0,0,0,0
Maldives,MDV,2019,0,0,0,0,0,0,0
Maldives,MDV,2004,0,0,3375896,0,0,0,3375896
Maldives,MDV,1991,0,0,0,0,0,0,0
Maldives,MDV,2021,0,0,0,0,0,0,0
Mali,MLI,1910,0,0,0,0,0,0,0
Mali,MLI,1940,0,0,0,0,0,0,0
Mali,MLI,1966,0,0,0,0,0,0,0
Mali,MLI,1976,0,0,0,0,0,0,0
Mali,MLI,1980,0,0,0,0,0,0,0
Mali,MLI,1991,0,0,0,0,0,0,0
Mali,MLI,2001,0,1727,0,0,0,0,1727
Mali,MLI,2005,0,0,0,0,0,0,0
Mali,MLI,2006,0,734,0,0,0,0,734
Mali,MLI,2010,0,0,0,0,0,0,0
Mali,MLI,2011,0,623,0,0,0,0,623
Mali,MLI,2020,0,0,0,0,0,0,0
Mali,MLI,2022,0,4426,0,0,0,0,4426
Mali,MLI,1988,0,19727,0,0,0,0,19727
Mali,MLI,1989,0,1140,0,0,0,0,1140
Mali,MLI,1998,0,2825,0,0,0,0,2825
Mali,MLI,1999,0,1832,0,0,0,0,1832
Mali,MLI,2000,0,13346,0,0,0,0,13346
Mali,MLI,2002,0,1673,0,0,0,0,1673
Mali,MLI,2003,0,0,0,0,0,0,0
Mali,MLI,2007,0,12783,0,0,0,0,12783
Mali,MLI,2008,0,0,0,0,0,0,0
Mali,MLI,2009,0,16630,0,0,0,0,16630
Mali,MLI,2013,0,21760,0,0,0,0,21760
Mali,MLI,2015,0,2760,0,0,0,0,2760
Mali,MLI,2016,0,6952,0,0,0,0,6952
Mali,MLI,2018,0,0,0,0,0,0,0
Mali,MLI,2019,0,7293,0,0,0,0,7293
Malta,MLT,2022,0,0,0,0,1425108,0,1425108
Marshall Islands,MHL,2013,0,0,0,0,0,0,0
Marshall Islands,MHL,2015,0,0,0,0,0,0,0
Marshall Islands,MHL,2022,0,0,0,0,0,0,0
Marshall Islands,MHL,2008,0,0,0,0,0,0,0
Marshall Islands,MHL,2014,0,0,0,0,0,0,0
Marshall Islands,MHL,1991,0,0,0,0,0,0,0
Marshall Islands,MHL,2018,0,0,0,0,0,0,0
Martinique,MTQ,2007,0,0,25263,25263,0,0,50526
Martinique,MTQ,1960,0,0,0,0,0,0,0
Martinique,MTQ,1963,0,0,0,327557,0,0,327557
Martinique,MTQ,1967,0,0,0,466743,0,0,466743
Martinique,MTQ,1970,0,0,0,1378508,0,0,1378508
Martinique,MTQ,1979,0,0,0,0,0,0,0
Martinique,MTQ,1980,0,0,0,0,0,0,0
Martinique,MTQ,1989,0,0,0,0,0,0,0
Martinique,MTQ,1990,0,0,0,213744,0,0,213744
Martinique,MTQ,1993,0,0,0,50560,0,0,50560
Martinique,MTQ,1995,0,0,0,0,0,0,0
Martinique,MTQ,1996,0,0,0,0,0,0,0
Martinique,MTQ,1999,0,0,0,0,0,0,0
Martinique,MTQ,2011,0,0,0,25666,0,0,25666
Martinique,MTQ,2017,0,0,0,0,0,0,0
Mauritania,MRT,1910,0,0,0,0,0,0,0
Mauritania,MRT,1940,0,0,0,0,0,0,0
Mauritania,MRT,1965,0,0,0,0,0,0,0
Mauritania,MRT,1969,0,0,0,0,0,0,0
Mauritania,MRT,1976,0,0,0,0,0,0,0
Mauritania,MRT,1978,0,0,0,0,0,0,0
Mauritania,MRT,1980,0,0,0,0,0,0,0
Mauritania,MRT,1993,0,0,0,0,0,0,0
Mauritania,MRT,1997,0,0,0,0,0,0,0
Mauritania,MRT,2001,0,0,0,0,0,0,0
Mauritania,MRT,2010,0,0,0,0,0,0,0
Mauritania,MRT,2011,0,0,0,0,0,0,0
Mauritania,MRT,2017,0,0,0,43269,0,0,43269
Mauritania,MRT,2018,0,0,0,0,0,0,0
Mauritania,MRT,2020,0,20006,0,0,0,0,20006
Mauritania,MRT,1984,0,0,0,0,0,0,0
Mauritania,MRT,1985,0,0,0,0,0,0,0
Mauritania,MRT,1995,0,0,0,0,0,0,0
Mauritania,MRT,1999,0,0,0,3816,0,0,3816
Mauritania,MRT,2002,0,88599,0,0,0,0,88599
Mauritania,MRT,2003,0,31214,0,0,0,0,31214
Mauritania,MRT,2005,0,0,0,0,0,0,0
Mauritania,MRT,2006,0,22718,0,0,0,0,22718
Mauritania,MRT,2007,0,9513,0,0,0,0,9513
Mauritania,MRT,2009,0,3010,0,0,0,0,3010
Mauritania,MRT,2013,0,21373,0,0,0,0,21373
Mauritania,MRT,2019,0,6843,0,0,0,0,6843
Mauritania,MRT,2022,0,29560,0,0,0,0,29560
Mauritania,MRT,2023,0,2056,0,0,0,0,2056
Mauritania,MRT,1991,0,0,0,19358,0,0,19358
Mauritius,MUS,1999,0,0,0,0,0,0,0
Mauritius,MUS,2013,0,85225,0,0,0,0,85225
Mauritius,MUS,1960,0,0,0,620668,0,0,620668
Mauritius,MUS,1967,0,0,0,0,0,0,0
Mauritius,MUS,1972,0,0,0,23418,0,0,23418
Mauritius,MUS,1975,0,0,0,101318,0,0,101318
Mauritius,MUS,1979,0,0,0,53189,0,0,53189
Mauritius,MUS,1982,0,0,0,0,0,0,0
Mauritius,MUS,1983,0,0,0,10020,0,0,10020
Mauritius,MUS,1989,0,0,0,9285,0,0,9285
Mauritius,MUS,1991,0,0,0,0,0,0,0
Mauritius,MUS,1994,0,0,0,17434,0,0,17434
Mauritius,MUS,1996,0,0,0,25585,0,0,25585
Mauritius,MUS,2002,0,0,0,24312,0,0,24312
Mauritius,MUS,2007,0,0,0,15741,0,0,15741
Mauritius,MUS,2018,0,0,0,0,0,0,0
Mauritius,MUS,2022,0,0,0,7695,0,0,7695
Mauritius,MUS,2023,0,0,0,7689,0,0,7689
Mexico,MEX,1978,0,936,1404,0,0,0,2340
Mexico,MEX,1988,0,0,0,36506,2915,0,39421
Mexico,MEX,1995,0,0,7114,18895,5446,0,31455
Mexico,MEX,1996,0,0,0,1747,0,0,1747
Mexico,MEX,1999,0,67888,4775,934,1557,0,75154
Mexico,MEX,2002,0,3666,0,1585,4955,0,10206
Mexico,MEX,2011,0,6745,175,3767,263,0,10950
Mexico,MEX,1952,0,48173,0,0,0,0,48173
Mexico,MEX,1959,0,568514,7106,272887,0,0,848507
Mexico,MEX,1965,0,6318,0,0,0,0,6318
Mexico,MEX,1967,0,0,0,24312,0,0,24312
Mexico,MEX,1970,0,6960,0,0,0,0,6960
Mexico,MEX,1972,0,6910,0,0,0,0,6910
Mexico,MEX,1973,0,23539,100673,0,0,0,124212
Mexico,MEX,1979,0,0,758,0,0,0,758
Mexico,MEX,1980,0,15361,9896,0,0,0,25257
Mexico,MEX,1982,0,3538,2689,31844,0,14153,52224
Mexico,MEX,1984,0,0,0,544,0,0,544
Mexico,MEX,1986,0,2624,0,0,0,0,2624
Mexico,MEX,1987,0,2063,258,0,0,0,2321
Mexico,MEX,1989,0,4985,374,0,0,0,5359
Mexico,MEX,1990,0,5507,0,4650,46500,0,56657
Mexico,MEX,1991,0,2759,0,1560,0,0,4319
Mexico,MEX,1993,0,7502,0,4386,0,0,11888
Mexico,MEX,1998,0,45585,0,26908,10552,6542,89587
Mexico,MEX,2000,0,14202,0,3167,6743,0,24112
Mexico,MEX,2001,0,2113,0,503,0,0,2616
Mexico,MEX,2003,0,586,2831,391,2050,976,6834
Mexico,MEX,2004,0,3656,0,0,1347,0,5003
Mexico,MEX,2005,0,3888,0,4457,0,0,8345
Mexico,MEX,2006,0,0,0,1403,468,1965,3836
Mexico,MEX,2007,0,2031,0,1847,0,1477,5355
Mexico,MEX,2008,0,1094,0,182,0,2006,3282
Mexico,MEX,2009,0,2521,0,360,0,0,2881
Mexico,MEX,2010,0,5865,178,3821,0,6309,16173
Mexico,MEX,2013,0,1108,0,17904,0,0,19012
Mexico,MEX,2015,0,0,0,3496,0,0,3496
Mexico,MEX,2016,0,2057,0,5349,0,0,7406
Mexico,MEX,2017,0,163,38017,2361,0,0,40541
Mexico,MEX,2018,0,1613,0,1613,0,0,3226
Mexico,MEX,2019,0,959,0,320,0,0,1279
Mexico,MEX,2020,0,2381,794,3333,0,0,6508
Mexico,MEX,2021,0,2368,237,2999,0,0,5604
Mexico,MEX,2022,0,1020,392,2980,0,0,4392
Mexico,MEX,1911,0,0,30935,0,0,0,30935
Mexico,MEX,1920,0,0,444457,0,0,0,444457
Mexico,MEX,1932,0,0,231986,0,0,0,231986
Mexico,MEX,1937,0,0,18096,0,0,0,18096
Mexico,MEX,1957,0,0,48135,0,0,0,48135
Mexico,MEX,1964,0,0,10887,0,0,0,10887
Mexico,MEX,1968,0,0,6996,0,8480,0,15476
Mexico,MEX,1981,0,0,433,14444,0,0,14877
Mexico,MEX,1985,0,0,1268832,0,0,0,1268832
Mexico,MEX,1997,0,0,107,25970,31336,3434,60847
Mexico,MEX,2012,0,0,173,1641,0,0,1814
Mexico,MEX,2014,0,0,253,1600,0,0,1853
Mexico,MEX,1951,0,0,0,17650,0,0,17650
Mexico,MEX,1955,0,0,0,254355,0,0,254355
Mexico,MEX,1961,0,0,0,116455,0,0,116455
Mexico,MEX,1966,0,0,0,3169,0,0,3169
Mexico,MEX,1969,0,0,0,11906,0,3695,15601
Mexico,MEX,1971,0,0,0,3276,0,0,3276
Mexico,MEX,1974,0,0,0,2283,0,0,2283
Mexico,MEX,1975,0,0,0,4941,0,0,4941
Mexico,MEX,1976,0,0,0,119102,0,0,119102
Mexico,MEX,1977,0,0,0,1606,0,0,1606
Mexico,MEX,1983,0,0,0,38152,0,6937,45089
Mexico,MEX,1992,0,0,0,353,9413,0,9766
Mexico,MEX,1962,0,0,0,0,12925,0,12925
Mexico,MEX,1943,0,0,0,0,0,0,0
Mexico,MEX,1949,0,0,0,0,0,374145,374145
Mexico,MEX,1994,0,0,0,0,0,0,0
Mexico,MEX,1954,0,0,0,0,0,32662,32662
Mexico,MEX,1929,0,0,0,0,0,36510,36510
Micronesia,FSM,1998,0,0,0,0,0,0,0
Micronesia,FSM,2016,0,0,0,0,0,0,0
Micronesia,FSM,2008,0,0,0,0,0,0,0
Micronesia,FSM,1987,0,0,0,538445,0,0,538445
Micronesia,FSM,2002,0,0,0,4196241,0,0,4196241
Micronesia,FSM,2003,0,0,0,0,0,0,0
Micronesia,FSM,2004,0,0,0,89729,0,0,89729
Micronesia,FSM,2015,0,0,0,456717,0,0,456717
Micronesia,FSM,2019,0,0,0,0,0,0,0
Moldova,MDA,2000,4704,0,0,0,0,0,4704
Moldova,MDA,2007,0,0,0,0,0,0,0
Moldova,MDA,2012,0,0,0,0,28513,0,28513
Moldova,MDA,1994,0,104852,0,6693,0,0,111545
Moldova,MDA,1997,0,20483,0,0,0,0,20483
Moldova,MDA,1999,0,0,0,0,0,0,0
Moldova,MDA,2002,0,2411,0,0,0,0,2411
Moldova,MDA,2005,0,0,0,0,32489,0,32489
Moldova,MDA,2008,0,7869,0,0,0,0,7869
Moldova,MDA,2010,0,2719,0,0,0,0,2719
Moldova,MDA,2019,0,0,0,0,0,0,0
Mongolia,MNG,2000,0,0,0,93840,0,0,93840
Mongolia,MNG,1966,0,488954,0,0,0,0,488954
Mongolia,MNG,1982,0,0,0,0,0,0,0
Mongolia,MNG,1994,0,21725,0,0,0,0,21725
Mongolia,MNG,1996,0,173947,0,0,0,106065,280012
Mongolia,MNG,2003,0,59608,0,0,0,0,59608
Mongolia,MNG,2009,0,97498,0,0,18750,0,116248
Mongolia,MNG,2018,0,0,0,0,0,0,0
Mongolia,MNG,2019,0,37124,0,0,0,0,37124
Mongolia,MNG,2020,0,30355,0,0,0,0,30355
Mongolia,MNG,2021,0,0,0,35845,0,0,35845
Mongolia,MNG,2022,0,0,0,0,0,0,0
Mongolia,MNG,2023,0,11604,0,0,5802,0,17406
Mongolia,MNG,1957,0,0,13498859,0,0,0,13498859
Mongolia,MNG,1990,0,0,0,166556,0,0,166556
Mongolia,MNG,1991,0,0,0,27272,0,0,27272
Mongolia,MNG,1993,0,0,0,30833,0,0,30833
Mongolia,MNG,2001,0,0,0,64709,0,0,64709
Mongolia,MNG,2002,0,0,0,12026,0,0,12026
Mongolia,MNG,2008,0,0,0,197426,0,0,197426
Mongolia,MNG,2015,0,0,0,0,0,0,0
Mongolia,MNG,2016,0,0,0,0,0,0,0
Mongolia,MNG,2017,0,0,0,0,0,54909,54909
Mongolia,MNG,1986,0,0,0,0,0,0,0
Montenegro,MNE,2007,0,0,0,0,0,0,0
Montenegro,MNE,2009,0,0,0,0,0,0,0
Montenegro,MNE,2010,0,0,0,0,0,0,0
Montenegro,MNE,2012,0,0,0,0,15796,0,15796
Montenegro,MNE,2022,0,0,0,0,797344,0,797344
Montenegro,MNE,2017,0,0,0,0,0,0,0
Montserrat,MSR,1989,0,0,0,10075105,0,0,10075105
Montserrat,MSR,1990,0,0,0,0,0,0,0
Montserrat,MSR,1995,0,0,0,0,0,0,0
Montserrat,MSR,1996,0,0,0,0,0,0,0
Montserrat,MSR,1997,0,0,0,0,0,45121265,45121265
Montserrat,MSR,2006,0,0,0,0,0,0,0
Morocco,MAR,1966,0,0,0,0,0,0,0
Morocco,MAR,1971,0,0,0,0,0,0,0
Morocco,MAR,1983,0,0,0,0,0,0,0
Morocco,MAR,1984,0,0,0,0,0,0,0
Morocco,MAR,1999,0,0,0,0,0,0,0
Morocco,MAR,1951,0,142568,0,0,0,0,142568
Morocco,MAR,1954,0,30109,0,0,0,0,30109
Morocco,MAR,1963,0,132792,0,0,0,0,132792
Morocco,MAR,1964,0,58263,0,0,0,0,58263
Morocco,MAR,1965,0,56046,0,0,0,0,56046
Morocco,MAR,1970,0,7202,0,0,0,0,7202
Morocco,MAR,1975,0,5772,0,0,0,0,5772
Morocco,MAR,1977,0,0,0,0,0,0,0
Morocco,MAR,1979,0,8347,0,0,0,0,8347
Morocco,MAR,1995,0,297379,0,0,0,0,297379
Morocco,MAR,1996,0,9260,0,5185,0,0,14445
Morocco,MAR,1997,0,21900,0,0,0,0,21900
Morocco,MAR,2000,0,2101,0,0,0,0,2101
Morocco,MAR,2001,0,5185,0,0,0,0,5185
Morocco,MAR,2002,0,27302,0,0,0,0,27302
Morocco,MAR,2003,0,11800,0,0,0,0,11800
Morocco,MAR,2006,0,5514,0,0,0,0,5514
Morocco,MAR,2008,0,12328,0,0,0,0,12328
Morocco,MAR,2009,0,9050,0,0,0,0,9050
Morocco,MAR,2010,0,12937,0,0,0,0,12937
Morocco,MAR,2014,0,3212,0,14307,0,0,17519
Morocco,MAR,2019,0,6611,0,0,0,4132,10743
Morocco,MAR,2021,0,6473,0,0,0,0,6473
Morocco,MAR,1909,0,0,186039,0,0,0,186039
Morocco,MAR,1960,0,0,10195601,0,0,0,10195601
Morocco,MAR,1969,0,0,7394,0,0,0,7394
Morocco,MAR,2004,0,0,209102,0,0,0,209102
Morocco,MAR,2005,0,0,0,329,0,0,329
Morocco,MAR,2012,0,0,0,0,0,0,0
Morocco,MAR,2016,0,0,0,0,0,0,0
Morocco,MAR,2017,0,0,0,0,0,0,0
Morocco,MAR,2018,0,0,0,0,0,0,0
Morocco,MAR,1982,0,0,0,0,0,482,482
Morocco,MAR,1988,0,0,0,0,0,13069,13069
Mozambique,MOZ,1979,0,0,0,0,0,0,0
Mozambique,MOZ,1981,85910504,0,0,0,0,0,85910504
Mozambique,MOZ,1987,38566,0,0,0,0,0,38566
Mozambique,MOZ,1990,0,0,0,0,0,0,0
Mozambique,MOZ,1998,0,0,0,0,0,51409,51409
Mozambique,MOZ,2001,4939,43357,0,0,0,0,48296
Mozambique,MOZ,2003,4691,19805,0,5733,0,0,30229
Mozambique,MOZ,2005,0,7916,0,0,0,0,7916
Mozambique,MOZ,2007,0,25375,0,4699,0,0,30074
Mozambique,MOZ,2008,0,11444,0,4120,0,22430,37994
Mozambique,MOZ,2010,0,2167,0,0,0,0,2167
Mozambique,MOZ,2016,0,22747,0,4333,0,0,27080
Mozambique,MOZ,2020,0,7698,0,0,0,0,7698
Mozambique,MOZ,2021,0,0,0,3429,0,0,3429
Mozambique,MOZ,1967,0,0,0,0,0,0,0
Mozambique,MOZ,1971,0,579852,0,0,0,0,579852
Mozambique,MOZ,1975,0,1031,0,0,0,0,1031
Mozambique,MOZ,1977,0,289475,0,2895,0,0,292370
Mozambique,MOZ,1978,0,37240,0,3724,0,0,40964
Mozambique,MOZ,1985,0,6309,0,0,0,0,6309
Mozambique,MOZ,1989,0,1528,0,0,0,0,1528
Mozambique,MOZ,1997,0,21184,0,0,0,0,21184
Mozambique,MOZ,1999,0,13266,0,0,0,0,13266
Mozambique,MOZ,2000,0,450235,0,18009,0,0,468244
Mozambique,MOZ,2002,0,0,0,1605,0,0,1605
Mozambique,MOZ,2009,0,0,0,0,0,0,0
Mozambique,MOZ,2011,0,4630,0,5050,0,0,9680
Mozambique,MOZ,2013,0,47125,0,0,0,0,47125
Mozambique,MOZ,2014,0,8449,0,0,0,0,8449
Mozambique,MOZ,2015,0,59605,0,0,0,0,59605
Mozambique,MOZ,2018,0,3738,0,0,0,5778,9516
Mozambique,MOZ,2019,0,18491,0,213963,0,0,232454
Mozambique,MOZ,2022,0,26691,0,34881,0,0,61572
Mozambique,MOZ,2023,0,4130,0,48676,0,0,52806
Mozambique,MOZ,2006,0,0,1929,0,0,0,1929
Mozambique,MOZ,1956,0,0,0,167079,0,0,167079
Mozambique,MOZ,1984,0,0,0,87718,0,0,87718
Mozambique,MOZ,1988,0,0,0,77180,0,0,77180
Mozambique,MOZ,1994,0,0,0,160935,0,0,160935
Mozambique,MOZ,1996,0,0,0,6841,0,0,6841
Mozambique,MOZ,2012,0,0,0,13476,0,0,13476
Mozambique,MOZ,2017,0,0,0,2450,0,0,2450
Myanmar [Burma],MMR,1965,0,13999,0,41174,0,0,55173
Myanmar [Burma],MMR,1970,0,32986,0,0,0,0,32986
Myanmar [Burma],MMR,1974,0,0,0,0,0,0,0
Myanmar [Burma],MMR,1976,0,0,0,0,0,0,0
Myanmar [Burma],MMR,1977,0,951,0,0,0,0,951
Myanmar [Burma],MMR,1979,0,0,0,0,0,0,0
Myanmar [Burma],MMR,1991,0,5654,0,0,0,0,5654
Myanmar [Burma],MMR,1992,0,1212,0,0,0,0,1212
Myanmar [Burma],MMR,1995,0,11894,0,0,0,0,11894
Myanmar [Burma],MMR,1997,0,15464,0,0,0,0,15464
Myanmar [Burma],MMR,1999,0,4884,0,0,0,0,4884
Myanmar [Burma],MMR,2001,0,11083,0,0,0,0,11083
Myanmar [Burma],MMR,2002,0,4518,0,0,0,0,4518
Myanmar [Burma],MMR,2006,0,5199,0,7070,0,0,12269
Myanmar [Burma],MMR,2007,0,1032,0,0,0,0,1032
Myanmar [Burma],MMR,2011,0,30325,14861,0,0,0,45186
Myanmar [Burma],MMR,2012,0,398,7567,0,0,0,7965
Myanmar [Burma],MMR,2013,0,1382,0,0,0,3159,4541
Myanmar [Burma],MMR,2014,0,0,0,0,0,0,0
Myanmar [Burma],MMR,2015,0,33408,0,583,0,7381,41372
Myanmar [Burma],MMR,2016,0,3661,771,6167,0,8094,18693
Myanmar [Burma],MMR,2017,0,574,0,0,0,0,574
Myanmar [Burma],MMR,2018,0,6646,0,0,0,6076,12722
Myanmar [Burma],MMR,2019,0,21682,0,0,0,2451,24133
Myanmar [Burma],MMR,2020,0,0,0,0,0,32570,32570
Myanmar [Burma],MMR,2021,0,0,0,0,0,0,0
Myanmar [Burma],MMR,2023,0,916,0,28033,0,7146,36095
Myanmar [Burma],MMR,1930,0,0,442869,0,0,0,442869
Myanmar [Burma],MMR,1941,0,0,9770,0,0,0,9770
Myanmar [Burma],MMR,2004,0,0,14998,49854,0,0,64852
Myanmar [Burma],MMR,1902,0,0,0,613986,0,0,613986
Myanmar [Burma],MMR,1923,0,0,0,4882,0,0,4882
Myanmar [Burma],MMR,1926,0,0,0,2130276,0,0,2130276
Myanmar [Burma],MMR,1936,0,0,0,698696,0,0,698696
Myanmar [Burma],MMR,1963,0,0,0,0,0,0,0
Myanmar [Burma],MMR,1967,0,0,0,109277,0,0,109277
Myanmar [Burma],MMR,1968,0,0,0,410841,0,0,410841
Myanmar [Burma],MMR,1975,0,0,0,65910,0,0,65910
Myanmar [Burma],MMR,1978,0,0,0,0,0,0,0
Myanmar [Burma],MMR,1982,0,0,0,3166,0,0,3166
Myanmar [Burma],MMR,1994,0,0,0,4015,0,0,4015
Myanmar [Burma],MMR,2008,0,0,0,28394720,0,0,28394720
Myanmar [Burma],MMR,2010,0,0,0,9111,0,13768,22879
Myanmar [Burma],MMR,2005,0,0,0,0,0,3562,3562
Myanmar [Burma],MMR,2009,0,0,0,0,0,4896,4896
Myanmar [Burma],MMR,1981,0,0,0,0,0,2345,2345
Namibia,NAM,1981,0,0,0,0,0,0,0
Namibia,NAM,1990,0,0,0,0,0,0,0
Namibia,NAM,1995,0,0,0,0,0,0,0
Namibia,NAM,1998,0,0,0,0,0,0,0
Namibia,NAM,2001,0,0,0,0,0,0,0
Namibia,NAM,2002,0,0,0,0,0,0,0
Namibia,NAM,2013,0,0,0,0,0,0,0
Namibia,NAM,2015,0,0,0,0,0,0,0
Namibia,NAM,2018,0,0,0,0,0,0,0
Namibia,NAM,2000,0,0,0,0,0,0,0
Namibia,NAM,2003,0,10442,0,0,0,0,10442
Namibia,NAM,2004,0,0,0,0,0,0,0
Namibia,NAM,2006,0,25169,0,0,0,0,25169
Namibia,NAM,2007,0,34800,0,0,0,0,34800
Namibia,NAM,2008,0,206028,0,0,0,0,206028
Namibia,NAM,2009,0,444890,0,0,0,0,444890
Namibia,NAM,2010,0,38108,0,0,0,0,38108
Namibia,NAM,2011,0,506485,0,0,0,0,506485
Namibia,NAM,2012,0,0,0,0,0,0,0
Namibia,NAM,2017,0,0,0,0,0,0,0
Namibia,NAM,2020,0,0,0,0,0,0,0
Namibia,NAM,2021,0,0,0,0,0,0,0
Namibia,NAM,2023,0,0,0,0,0,0,0
Nepal,NPL,1964,0,0,0,0,0,0,0
Nepal,NPL,1967,0,0,0,0,0,0,0
Nepal,NPL,1972,0,0,0,0,0,80446,80446
Nepal,NPL,1979,0,0,0,0,0,0,0
Nepal,NPL,2006,0,0,0,0,0,59203,59203
Nepal,NPL,2009,0,43290,0,0,6660,3700,53650
Nepal,NPL,1954,0,65856,0,0,0,0,65856
Nepal,NPL,1968,0,230569,0,0,0,0,230569
Nepal,NPL,1970,0,279971,0,0,0,16798,296769
Nepal,NPL,1978,0,87314,0,0,0,0,87314
Nepal,NPL,1981,0,469637,0,0,0,0,469637
Nepal,NPL,1982,0,56279,0,0,0,0,56279
Nepal,NPL,1983,0,111107,0,0,0,12544,123651
Nepal,NPL,1984,0,116675,0,0,0,0,116675
Nepal,NPL,1985,0,26225,0,0,0,0,26225
Nepal,NPL,1986,0,12265,0,558,0,0,12823
Nepal,NPL,1987,0,102585,0,0,0,0,102585
Nepal,NPL,1988,0,14423,378724,37392,0,56622,487161
Nepal,NPL,1990,0,15293,0,0,0,0,15293
Nepal,NPL,1991,0,25334,0,2981,0,0,28315
Nepal,NPL,1993,0,492774,0,0,0,13166,505940
Nepal,NPL,1995,0,62765,0,0,0,80697,143462
Nepal,NPL,1996,0,345857,0,8778,0,0,354635
Nepal,NPL,1998,0,130783,0,0,0,0,130783
Nepal,NPL,1999,0,70413,0,0,0,13254,83667
Nepal,NPL,2000,0,58633,0,0,0,0,58633
Nepal,NPL,2003,0,93058,0,0,18689,0,111747
Nepal,NPL,2004,0,71143,0,0,0,0,71143
Nepal,NPL,2005,0,19403,0,0,0,6848,26251
Nepal,NPL,2007,0,80109,0,0,0,0,80109
Nepal,NPL,2008,0,42780,0,0,0,0,42780
Nepal,NPL,2010,0,55225,0,0,0,0,55225
Nepal,NPL,2011,0,38142,2567,0,15404,10636,66749
Nepal,NPL,2012,0,26344,0,0,17929,4025,48298
Nepal,NPL,2013,0,71216,0,0,0,0,71216
Nepal,NPL,2014,0,115796,0,30223,0,62632,208651
Nepal,NPL,2016,0,58504,0,0,0,3948,62452
Nepal,NPL,2017,0,66351,0,0,0,3903,70254
Nepal,NPL,2018,0,5262,0,0,17540,0,22802
Nepal,NPL,2019,0,41273,0,9711,0,0,50984
Nepal,NPL,2020,0,152648,0,0,0,0,152648
Nepal,NPL,2021,0,83569,0,0,0,0,83569
Nepal,NPL,2022,0,48122,1964,6875,0,7202,64163
Nepal,NPL,2023,0,11652,0,0,0,0,11652
Nepal,NPL,1966,0,0,69746,0,0,0,69746
Nepal,NPL,1980,0,0,64101,0,0,0,64101
Nepal,NPL,2015,0,0,3248422,0,0,23542,3271964
Nepal,NPL,2002,0,0,0,0,23685,186324,210009
Nepal,NPL,1975,0,0,0,0,0,89763,89763
Nepal,NPL,1976,0,0,0,0,0,105406,105406
Nepal,NPL,1989,0,0,0,0,0,25594,25594
Nepal,NPL,1997,0,0,0,0,0,8602,8602
Nepal,NPL,2001,0,0,0,0,0,57701,57701
Nepal,NPL,1992,0,0,0,0,0,27050,27050
Nepal,NPL,1963,0,0,0,0,0,139111,139111
Netherlands,NLD,1953,0,1905252,0,0,0,0,1905252
Netherlands,NLD,1992,0,0,0,0,0,0,0
Netherlands,NLD,1993,0,656,0,0,0,0,656
Netherlands,NLD,1998,0,0,0,0,0,0,0
Netherlands,NLD,2021,0,0,0,0,0,0,0
Netherlands,NLD,1972,0,0,0,0,0,0,0
Netherlands,NLD,1976,0,0,0,0,0,0,0
Netherlands,NLD,1984,0,0,0,0,0,0,0
Netherlands,NLD,1985,0,0,0,0,0,0,0
Netherlands,NLD,1986,0,0,0,0,0,0,0
Netherlands,NLD,1990,0,0,0,13383,0,0,13383
Netherlands,NLD,1994,0,0,0,0,0,0,0
Netherlands,NLD,1995,0,0,0,647,0,0,647
Netherlands,NLD,1997,0,0,0,1280,0,0,1280
Netherlands,NLD,2002,0,0,0,2491,0,0,2491
Netherlands,NLD,2005,0,0,0,0,0,0,0
Netherlands,NLD,2007,0,0,0,4271,0,0,4271
Netherlands,NLD,2008,0,0,0,0,0,0,0
Netherlands,NLD,2010,0,0,0,0,0,0,0
Netherlands,NLD,2013,0,0,0,1186,0,0,1186
Netherlands,NLD,2016,0,0,0,0,0,0,0
Netherlands,NLD,2018,0,0,0,1736,0,0,1736
Netherlands,NLD,2022,0,0,0,2277,267023,0,269300
Netherlands,NLD,2003,0,0,0,0,598354,0,598354
Netherlands,NLD,2006,0,0,0,0,612532,0,612532
Netherlands,NLD,2012,0,0,0,0,596,0,596
Netherlands,NLD,2019,0,0,0,0,230371,0,230371
Netherlands,NLD,2020,0,0,0,0,229429,0,229429
Netherlands Antilles,ANT,1960,0,0,0,0,0,0,0
New Caledonia,NCL,1951,0,0,0,307863,0,0,307863
New Caledonia,NCL,1955,0,0,0,142861,0,0,142861
New Caledonia,NCL,1959,0,0,0,127246,0,0,127246
New Caledonia,NCL,1968,0,0,0,0,0,0,0
New Caledonia,NCL,1969,0,0,0,0,0,0,0
New Caledonia,NCL,1972,0,0,0,248176,0,0,248176
New Caledonia,NCL,1975,0,0,0,0,0,0,0
New Caledonia,NCL,1976,0,0,0,0,0,0,0
New Caledonia,NCL,1981,0,0,0,266237,0,0,266237
New Caledonia,NCL,1999,0,0,0,0,0,0,0
New Caledonia,NCL,2003,0,0,0,85218,0,0,85218
New Caledonia,NCL,2021,0,0,0,0,0,0,0
New Zealand,NZL,1992,0,0,0,0,0,0,0
New Zealand,NZL,2013,0,0,0,0,0,0,0
New Zealand,NZL,1938,0,131039,0,0,0,0,131039
New Zealand,NZL,1976,0,0,0,0,0,0,0
New Zealand,NZL,1977,0,0,0,0,0,0,0
New Zealand,NZL,1978,0,0,0,0,0,0,0
New Zealand,NZL,1980,0,0,0,0,0,0,0
New Zealand,NZL,1981,0,0,0,0,0,0,0
New Zealand,NZL,1983,0,0,0,0,0,0,0
New Zealand,NZL,1984,0,0,0,0,0,0,0
New Zealand,NZL,1985,0,12239,0,0,0,0,12239
New Zealand,NZL,1986,0,3047,0,0,0,0,3047
New Zealand,NZL,1987,0,0,3031,0,0,0,3031
New Zealand,NZL,1988,0,3016,0,18094,0,0,21110
New Zealand,NZL,1989,0,0,0,0,0,0,0
New Zealand,NZL,1991,0,0,0,0,0,0,0
New Zealand,NZL,1994,0,0,0,0,0,0,0
New Zealand,NZL,1997,0,0,0,7945,0,0,7945
New Zealand,NZL,1998,0,0,0,0,0,0,0
New Zealand,NZL,1999,0,0,0,0,0,0,0
New Zealand,NZL,2000,0,0,0,0,0,0,0
New Zealand,NZL,2002,0,0,0,0,0,0,0
New Zealand,NZL,2004,0,9801,0,0,0,0,9801
New Zealand,NZL,2005,0,0,0,0,0,0,0
New Zealand,NZL,2006,0,0,0,0,0,0,0
New Zealand,NZL,2015,0,2178,0,0,0,0,2178
New Zealand,NZL,2016,0,0,4284,0,0,0,4284
New Zealand,NZL,2017,0,0,0,0,0,0,0
New Zealand,NZL,2018,0,0,0,0,0,0,0
New Zealand,NZL,2020,0,0,0,0,0,0,0
New Zealand,NZL,2021,0,0,0,1949,0,0,1949
New Zealand,NZL,2023,0,7651,0,21040,0,0,28691
New Zealand,NZL,1929,0,0,116456,0,0,0,116456
New Zealand,NZL,1931,0,0,1706159,0,0,0,1706159
New Zealand,NZL,1968,0,0,10884,181395,0,0,192279
New Zealand,NZL,2010,0,0,0,0,0,0,0
New Zealand,NZL,2011,0,0,415404,0,0,0,415404
New Zealand,NZL,1996,0,0,0,2682,0,0,2682
New Zealand,NZL,2003,0,0,0,4975,0,0,4975
New Zealand,NZL,2007,0,0,0,0,0,0,0
New Zealand,NZL,2012,0,0,0,6802,0,0,6802
New Zealand,NZL,2022,0,0,0,0,0,0,0
New Zealand,NZL,2001,0,0,0,0,0,0,0
New Zealand,NZL,1953,0,0,0,0,0,732078,732078
New Zealand,NZL,1995,0,0,0,0,0,0,0
New Zealand,NZL,2019,0,0,0,0,0,42347,42347
New Zealand,NZL,1979,0,0,0,0,0,0,0
Nicaragua,NIC,1994,0,0,0,0,0,0,0
Nicaragua,NIC,1997,0,0,0,0,0,0,0
Nicaragua,NIC,2000,0,0,13663,3904,0,0,17567
Nicaragua,NIC,2001,0,0,0,30812,0,0,30812
Nicaragua,NIC,2014,0,0,3221,0,0,0,3221
Nicaragua,NIC,2018,0,6086,0,0,0,0,6086
Nicaragua,NIC,1960,0,1815952,0,0,0,0,1815952
Nicaragua,NIC,1968,0,0,0,0,0,0,0
Nicaragua,NIC,1976,0,54284,0,0,0,0,54284
Nicaragua,NIC,1979,0,0,0,0,0,0,0
Nicaragua,NIC,1980,0,0,0,0,0,0,0
Nicaragua,NIC,1990,0,9461,0,0,0,0,9461
Nicaragua,NIC,1999,0,21783,0,0,0,0,21783
Nicaragua,NIC,2002,0,0,0,3803,0,0,3803
Nicaragua,NIC,2007,0,17833,0,315651,0,0,333484
Nicaragua,NIC,2008,0,29889,0,22856,0,0,52745
Nicaragua,NIC,2009,0,0,0,0,0,0,0
Nicaragua,NIC,2010,0,112710,0,8539,0,0,121249
Nicaragua,NIC,2011,0,28607,0,0,0,0,28607
Nicaragua,NIC,2012,0,14924,0,0,0,0,14924
Nicaragua,NIC,2013,0,44122,0,0,0,0,44122
Nicaragua,NIC,2015,0,3175,0,0,0,0,3175
Nicaragua,NIC,2017,0,10802,0,23146,0,0,33948
Nicaragua,NIC,1930,0,0,12063119,0,0,0,12063119
Nicaragua,NIC,1931,0,0,11889405,0,0,0,11889405
Nicaragua,NIC,1951,0,0,3650389,0,0,0,3650389
Nicaragua,NIC,1972,0,0,38414438,0,0,0,38414438
Nicaragua,NIC,1992,0,0,404321,0,0,2259,406580
Nicaragua,NIC,1998,0,0,0,6698092,0,0,6698092
Nicaragua,NIC,1971,0,0,0,138587,0,0,138587
Nicaragua,NIC,1982,0,0,0,203327,0,0,203327
Nicaragua,NIC,1988,0,0,0,322318,0,0,322318
Nicaragua,NIC,1993,0,0,0,81737,0,0,81737
Nicaragua,NIC,1995,0,0,0,80476,0,0,80476
Nicaragua,NIC,1996,0,0,0,91431,0,0,91431
Nicaragua,NIC,2004,0,0,0,0,0,53841,53841
Nicaragua,NIC,2005,0,0,0,12833,0,0,12833
Nicaragua,NIC,2016,0,0,0,0,0,0,0
Nicaragua,NIC,2020,0,0,0,29604,0,0,29604
Nicaragua,NIC,2022,0,0,0,7196,0,0,7196
Nicaragua,NIC,1991,0,0,0,0,0,0,0
Niger,NER,1903,0,0,0,0,0,0,0
Niger,NER,1906,0,0,0,0,0,0,0
Niger,NER,1910,568853300,0,0,0,0,0,568853300
Niger,NER,1940,0,0,0,0,0,0,0
Niger,NER,1966,0,0,0,0,0,0,0
Niger,NER,1980,0,0,0,0,0,0,0
Niger,NER,1988,0,25406,0,0,0,0,25406
Niger,NER,1990,0,0,0,0,0,0,0
Niger,NER,1997,0,0,0,0,0,0,0
Niger,NER,2001,0,3325,0,0,0,0,3325
Niger,NER,2005,0,0,0,0,0,0,0
Niger,NER,2009,0,1871,0,0,0,0,1871
Niger,NER,2011,0,9258,0,0,0,0,9258
Niger,NER,2015,0,13414,0,0,0,0,13414
Niger,NER,2017,0,33122,0,0,0,0,33122
Niger,NER,2020,0,34109,0,0,0,0,34109
Niger,NER,2022,0,74405,0,0,0,0,74405
Niger,NER,1974,0,0,0,0,0,0,0
Niger,NER,1994,0,63202,0,0,0,0,63202
Niger,NER,1998,0,0,0,0,0,0,0
Niger,NER,1999,0,12465,0,0,0,0,12465
Niger,NER,2000,0,1721,0,0,0,0,1721
Niger,NER,2003,0,5426,0,0,0,0,5426
Niger,NER,2006,0,2785,0,0,0,0,2785
Niger,NER,2007,0,4699,0,0,0,0,4699
Niger,NER,2008,0,4529,0,0,0,0,4529
Niger,NER,2010,0,3003,0,0,0,0,3003
Niger,NER,2012,0,50684,0,0,0,0,50684
Niger,NER,2013,0,17155,0,0,0,0,17155
Niger,NER,2014,0,18584,0,0,0,0,18584
Niger,NER,2016,0,29156,0,0,0,0,29156
Niger,NER,2018,0,15945,0,0,0,0,15945
Niger,NER,2019,0,22181,0,0,0,0,22181
Niger,NER,2021,0,24552,0,0,0,0,24552
Niger,NER,2023,0,2573,0,0,0,0,2573
Niger,NER,2002,0,0,0,3211,0,0,3211
Nigeria,NGA,1981,0,0,0,0,0,0,0
Nigeria,NGA,2022,0,27592,0,320,0,0,27912
Nigeria,NGA,1985,0,0,0,0,0,0,0
Nigeria,NGA,1988,0,14388,0,0,0,0,14388
Nigeria,NGA,1994,0,2845,0,0,0,0,2845
Nigeria,NGA,1998,0,1285,0,0,0,0,1285
Nigeria,NGA,1999,0,7436,0,8355,0,0,15791
Nigeria,NGA,2000,0,326,0,0,0,2605,2931
Nigeria,NGA,2001,0,15854,0,0,0,0,15854
Nigeria,NGA,2002,0,0,0,0,4630,0,4630
Nigeria,NGA,2003,0,1202,0,0,0,0,1202
Nigeria,NGA,2004,0,6874,0,0,0,0,6874
Nigeria,NGA,2005,0,4271,0,0,0,0,4271
Nigeria,NGA,2006,0,2771,0,0,0,0,2771
Nigeria,NGA,2007,0,6136,0,0,0,0,6136
Nigeria,NGA,2009,0,1980,0,0,0,0,1980
Nigeria,NGA,2010,0,2485,0,0,0,0,2485
Nigeria,NGA,2011,0,10516,0,665,0,0,11181
Nigeria,NGA,2012,0,21343,0,882,0,0,22225
Nigeria,NGA,2013,0,1087,0,0,0,0,1087
Nigeria,NGA,2014,0,836,0,0,0,0,836
Nigeria,NGA,2015,0,2881,0,0,0,0,2881
Nigeria,NGA,2016,0,954,0,1484,0,0,2438
Nigeria,NGA,2017,0,1034,0,0,0,0,1034
Nigeria,NGA,2018,0,15122,0,0,0,0,15122
Nigeria,NGA,2019,0,1180,0,0,0,0,1180
Nigeria,NGA,2020,0,9072,0,0,0,0,9072
Nigeria,NGA,2021,0,187,0,0,0,0,187
Nigeria,NGA,1978,0,0,0,14570,0,0,14570
Nigeria,NGA,1992,0,0,0,0,1797,0,1797
Niue,NIU,1959,0,0,0,0,0,0,0
Niue,NIU,1960,0,0,0,0,0,0,0
Niue,NIU,1968,0,0,0,0,0,0,0
Niue,NIU,1990,0,0,0,0,0,0,0
Niue,NIU,2004,0,0,0,5224661,0,0,5224661
North Korea,PRK,2012,0,35359,0,23706,0,0,59065
North Korea,PRK,2015,0,13065,0,0,0,0,13065
North Korea,PRK,2017,0,0,0,0,0,0,0
North Korea,PRK,2019,0,0,0,1941,0,0,1941
North Korea,PRK,1987,0,158260,0,0,0,0,158260
North Korea,PRK,1995,0,30377,0,0,0,0,30377
North Korea,PRK,1996,0,51295,0,0,0,0,51295
North Korea,PRK,1997,0,0,0,0,0,0,0
North Korea,PRK,1998,0,21717,0,0,0,0,21717
North Korea,PRK,1999,0,18100,0,0,0,0,18100
North Korea,PRK,2001,0,52738,0,0,0,0,52738
North Korea,PRK,2002,0,0,0,1269,0,0,1269
North Korea,PRK,2004,0,10021,0,0,0,0,10021
North Korea,PRK,2005,0,80080,0,0,0,0,80080
North Korea,PRK,2006,0,114707,0,0,0,0,114707
North Korea,PRK,2007,0,250446,0,0,0,0,250446
North Korea,PRK,2010,0,0,0,8102,0,0,8102
North Korea,PRK,2011,0,25823,0,4035,0,0,29858
North Korea,PRK,2013,0,20399,0,0,0,0,20399
North Korea,PRK,2016,0,217412,0,0,0,0,217412
North Korea,PRK,2018,0,57726,0,33544,0,0,91270
North Korea,PRK,2020,0,8505,0,0,0,0,8505
North Korea,PRK,2021,0,0,0,0,0,0,0
North Korea,PRK,1993,0,0,0,2756,0,0,2756
North Korea,PRK,2000,0,0,0,19686,0,0,19686
Northern Mariana Islands,MNP,2002,0,0,0,0,0,0,0
Northern Mariana Islands,MNP,2004,0,0,0,417148,0,0,417148
Northern Mariana Islands,MNP,2015,0,0,0,0,0,0,0
Northern Mariana Islands,MNP,2018,0,0,0,397393,0,0,397393
Northern Mariana Islands,MNP,2003,0,0,0,0,0,0,0
Norway,NOR,1995,0,2294,0,0,0,0,2294
Norway,NOR,2000,0,0,0,0,0,0,0
Norway,NOR,2001,0,0,0,0,0,0,0
Norway,NOR,1990,0,0,0,0,0,0,0
Norway,NOR,1992,0,0,0,0,0,0,0
Norway,NOR,1993,0,0,0,0,0,0,0
Norway,NOR,2005,0,0,0,0,0,0,0
Norway,NOR,2008,0,0,0,0,0,0,0
Norway,NOR,2011,0,0,0,8075,0,0,8075
Norway,NOR,2022,0,0,0,0,55205,0,55205
Norway,NOR,1936,0,0,0,0,0,249998,249998
Norway,NOR,2019,0,0,0,0,0,1870,1870
Norway,NOR,2020,0,0,0,0,0,18588,18588
Oman,OMN,2016,0,4547,0,0,0,0,4547
Oman,OMN,2017,0,6605,0,0,0,0,6605
Oman,OMN,2019,0,13036,0,0,0,0,13036
Oman,OMN,2020,0,6603,0,0,0,0,6603
Oman,OMN,1977,0,0,0,1235375,0,0,1235375
Oman,OMN,1981,0,0,0,241718,0,0,241718
Oman,OMN,2002,0,0,0,29122,0,0,29122
Oman,OMN,2003,0,0,0,123375,0,0,123375
Oman,OMN,2007,0,0,0,291668,0,0,291668
Oman,OMN,2010,0,0,0,55519,0,0,55519
Oman,OMN,2011,0,0,0,43656,0,0,43656
Oman,OMN,2015,0,0,0,0,0,0,0
Oman,OMN,2018,0,0,0,13040,0,0,13040
Oman,OMN,2021,0,0,0,44243,0,0,44243
Pakistan,PAK,1999,9553,2271,0,17235,735,0,29794
Pakistan,PAK,2019,3448,9226,1747,1747,0,0,16168
Pakistan,PAK,1950,0,769307,0,0,0,0,769307
Pakistan,PAK,1954,0,86018,0,0,0,0,86018
Pakistan,PAK,1956,0,64462,0,0,0,0,64462
Pakistan,PAK,1957,0,17520,0,0,0,0,17520
Pakistan,PAK,1959,0,22300,0,0,0,10704,33004
Pakistan,PAK,1964,0,0,0,89016,0,0,89016
Pakistan,PAK,1967,0,5858,0,0,0,0,5858
Pakistan,PAK,1973,0,73733,0,0,0,0,73733
Pakistan,PAK,1976,0,48127,0,0,0,0,48127
Pakistan,PAK,1977,0,117044,0,0,0,0,117044
Pakistan,PAK,1978,0,52548,0,0,0,0,52548
Pakistan,PAK,1979,0,1679,0,0,9043,0,10722
Pakistan,PAK,1980,0,9302,0,2233,0,0,11535
Pakistan,PAK,1981,0,9731,30378,6645,0,0,46754
Pakistan,PAK,1982,0,7742,0,0,0,0,7742
Pakistan,PAK,1983,0,4282,0,0,0,10430,14712
Pakistan,PAK,1984,0,4149,426,0,0,0,4575
Pakistan,PAK,1988,0,18154,0,3334,0,4631,26119
Pakistan,PAK,1989,0,1791,0,0,0,0,1791
Pakistan,PAK,1991,0,2013,25167,0,43875,2097,73152
Pakistan,PAK,1992,0,118161,3269,0,0,4494,125924
Pakistan,PAK,1993,0,1195,0,48508,0,4620,54323
Pakistan,PAK,1994,0,24450,0,2785,0,0,27235
Pakistan,PAK,1995,0,79854,0,0,0,0,79854
Pakistan,PAK,1996,0,8088,0,0,2332,3206,13626
Pakistan,PAK,1997,0,12099,3538,2901,7076,0,25614
Pakistan,PAK,1998,0,68740,69,825,0,894,70528
Pakistan,PAK,2001,0,13189,754,251,0,1947,16141
Pakistan,PAK,2002,0,2266,2389,858,6921,0,12434
Pakistan,PAK,2003,0,15940,0,3056,11985,719,31700
Pakistan,PAK,2004,0,293,1406,0,0,0,1699
Pakistan,PAK,2005,0,36474,4205833,3326,6079,1376,4253088
Pakistan,PAK,2006,0,22463,0,0,4717,1629,28809
Pakistan,PAK,2007,0,28913,0,13302,0,7860,50075
Pakistan,PAK,2008,0,4464,8928,0,0,0,13392
Pakistan,PAK,2009,0,5365,0,0,0,0,5365
Pakistan,PAK,2010,0,108663,0,1183,0,2571,112417
Pakistan,PAK,2011,0,25629,101,0,0,0,25730
Pakistan,PAK,2012,0,25617,0,0,0,7567,33184
Pakistan,PAK,2013,0,13052,22500,0,0,0,35552
Pakistan,PAK,2014,0,12245,0,768,6675,0,19688
Pakistan,PAK,2015,0,17396,13414,0,58255,616,89681
Pakistan,PAK,2016,0,17281,281,1592,0,0,19154
Pakistan,PAK,2017,0,8319,0,1202,0,416,9937
Pakistan,PAK,2018,0,2731,0,0,8192,0,10923
Pakistan,PAK,2020,0,22315,0,4710,0,704,27729
Pakistan,PAK,2021,0,9507,908,994,0,0,11409
Pakistan,PAK,2022,0,73741,1823,933,0,170,76667
Pakistan,PAK,2023,0,11809,457,42,0,457,12765
Pakistan,PAK,1909,0,0,121061,0,0,0,121061
Pakistan,PAK,1935,0,0,21011650,0,0,0,21011650
Pakistan,PAK,1945,0,0,1167027,0,0,0,1167027
Pakistan,PAK,1955,0,0,2925,0,0,0,2925
Pakistan,PAK,1972,0,0,15998,0,0,0,15998
Pakistan,PAK,1974,0,0,710515,0,0,0,710515
Pakistan,PAK,1985,0,0,515,0,0,0,515
Pakistan,PAK,1986,0,0,0,1093,0,0,1093
Pakistan,PAK,1990,0,0,1906,0,1560,0,3466
Pakistan,PAK,1926,0,0,0,0,0,0,0
Pakistan,PAK,1939,0,0,0,0,0,0,0
Pakistan,PAK,1944,0,0,0,0,0,0,0
Pakistan,PAK,1965,0,0,0,1928952,0,0,1928952
Pakistan,PAK,1953,0,0,0,0,28110,0,28110
Pakistan,PAK,1975,0,0,0,0,2055,0,2055
Pakistan,PAK,2000,0,0,0,0,1555,0,1555
Palau,PLW,2015,0,0,0,0,0,0,0
Palau,PLW,2012,0,0,0,0,0,0,0
Palau,PLW,2013,0,0,0,0,0,0,0
Palau,PLW,2021,0,0,0,0,0,0,0
Palestinian Territories,PSE,2008,0,0,0,0,0,0,0
Palestinian Territories,PSE,2010,0,0,0,0,0,0,0
Palestinian Territories,PSE,2012,0,0,0,0,0,0,0
Palestinian Territories,PSE,2013,0,11677,0,2335,0,0,14012
Palestinian Territories,PSE,2015,0,0,0,8919,0,0,8919
Palestinian Territories,PSE,2020,0,0,0,0,5977,0,5977
Palestinian Territories,PSE,2022,0,0,0,0,7619,0,7619
Panama,PAN,1983,0,0,0,0,0,0,0
Panama,PAN,2013,0,0,0,0,0,0,0
Panama,PAN,2015,0,0,0,0,0,0,0
Panama,PAN,2018,0,0,0,0,0,0,0
Panama,PAN,1966,0,148096,0,0,0,0,148096
Panama,PAN,1970,0,316582,0,0,0,0,316582
Panama,PAN,1972,0,0,0,0,0,0,0
Panama,PAN,1973,0,42512,0,0,0,0,42512
Panama,PAN,1978,0,101750,0,0,0,0,101750
Panama,PAN,1984,0,4656,0,0,0,0,4656
Panama,PAN,1986,0,8901,0,0,0,0,8901
Panama,PAN,1991,0,47961,119902,0,0,0,167863
Panama,PAN,1995,0,3682,0,0,0,0,3682
Panama,PAN,1999,0,3398,0,0,0,0,3398
Panama,PAN,2000,0,3331,0,0,0,0,3331
Panama,PAN,2001,0,0,0,0,0,0,0
Panama,PAN,2002,0,16021,0,0,0,0,16021
Panama,PAN,2003,0,0,6286,0,0,0,6286
Panama,PAN,2004,0,49332,0,0,0,0,49332
Panama,PAN,2005,0,9075,0,0,0,0,9075
Panama,PAN,2006,0,32655,0,0,0,0,32655
Panama,PAN,2007,0,5828,0,0,0,0,5828
Panama,PAN,2008,0,80108,0,0,0,0,80108
Panama,PAN,2009,0,0,0,0,0,0,0
Panama,PAN,2010,0,41395,0,0,0,0,41395
Panama,PAN,2011,0,0,0,0,0,0,0
Panama,PAN,2012,0,15979,0,0,0,0,15979
Panama,PAN,2014,0,23143,0,0,0,0,23143
Panama,PAN,2020,0,25615,0,193275,0,0,218890
Panama,PAN,2021,0,2298,0,0,0,0,2298
Panama,PAN,2022,0,0,0,0,0,0,0
Panama,PAN,1964,0,0,0,7865,0,0,7865
Panama,PAN,1988,0,0,0,127778,0,0,127778
Panama,PAN,1992,0,0,0,46978,0,0,46978
Panama,PAN,1998,0,0,0,10398,0,0,10398
Panama,PAN,2016,0,0,0,17386,0,0,17386
Panama,PAN,2017,0,0,0,17090,0,0,17090
Papua New Guinea,PNG,1980,0,0,0,0,0,0,0
Papua New Guinea,PNG,1997,120957,0,0,64510,0,0,185467
Papua New Guinea,PNG,2015,27643,0,0,0,0,0,27643
Papua New Guinea,PNG,1983,0,169508,30269,0,0,0,199777
Papua New Guinea,PNG,1992,0,0,0,0,0,0,0
Papua New Guinea,PNG,1993,0,0,123497,34952,0,0,158449
Papua New Guinea,PNG,1999,0,3758,0,0,0,0,3758
Papua New Guinea,PNG,2004,0,0,0,0,0,0,0
Papua New Guinea,PNG,2005,0,1539,1539,0,0,0,3078
Papua New Guinea,PNG,2006,0,1491,0,0,0,22361,23852
Papua New Guinea,PNG,2008,0,0,0,0,0,14010,14010
Papua New Guinea,PNG,2012,0,6229,0,0,0,74752,80981
Papua New Guinea,PNG,2013,0,0,0,0,0,0,0
Papua New Guinea,PNG,2014,0,0,0,0,0,0,0
Papua New Guinea,PNG,2016,0,0,0,0,0,0,0
Papua New Guinea,PNG,2019,0,2096,0,0,0,10479,12575
Papua New Guinea,PNG,2020,0,19488,0,0,0,23591,43079
Papua New Guinea,PNG,1951,0,0,19058280,0,0,19058280,38116560
Papua New Guinea,PNG,1970,0,0,60263,0,0,0,60263
Papua New Guinea,PNG,1985,0,0,0,0,0,0,0
Papua New Guinea,PNG,1986,0,0,0,0,0,0,0
Papua New Guinea,PNG,1987,0,0,2778,0,0,0,2778
Papua New Guinea,PNG,1990,0,0,0,0,0,0,0
Papua New Guinea,PNG,1998,0,0,4246096,0,0,0,4246096
Papua New Guinea,PNG,2000,0,0,3631,0,0,0,3631
Papua New Guinea,PNG,2001,0,0,0,0,0,0,0
Papua New Guinea,PNG,2002,0,0,8485,0,0,61094,69579
Papua New Guinea,PNG,2018,0,0,194014,0,0,0,194014
Papua New Guinea,PNG,2022,0,0,6902,0,0,0,6902
Papua New Guinea,PNG,2023,0,0,7744,0,0,0,7744
Papua New Guinea,PNG,1972,0,0,0,0,0,0,0
Papua New Guinea,PNG,2007,0,0,0,248517,0,0,248517
Papua New Guinea,PNG,2011,0,0,0,0,0,0,0
Papua New Guinea,PNG,1937,0,0,0,0,0,6164755,6164755
Papua New Guinea,PNG,1957,0,0,0,0,0,0,0
Papua New Guinea,PNG,1960,0,0,0,0,0,0,0
Papua New Guinea,PNG,1994,0,0,0,0,0,11232,11232
Papua New Guinea,PNG,1996,0,0,0,0,0,87758,87758
Papua New Guinea,PNG,1971,0,0,0,0,0,392261,392261
Papua New Guinea,PNG,1979,0,0,0,0,0,42736,42736
Papua New Guinea,PNG,1991,0,0,0,0,0,501127,501127
Papua New Guinea,PNG,2003,0,0,0,0,0,21343,21343
Papua New Guinea,PNG,2009,0,0,0,0,0,25819,25819
Papua New Guinea,PNG,1988,0,0,0,0,0,206541,206541
Paraguay,PRY,1963,0,0,0,0,0,0,0
Paraguay,PRY,1983,0,227322,0,0,0,0,227322
Paraguay,PRY,1999,23876,0,0,0,0,0,23876
Paraguay,PRY,2005,0,0,0,0,0,0,0
Paraguay,PRY,2008,7086,0,0,0,0,0,7086
Paraguay,PRY,2009,0,0,0,0,0,0,0
Paraguay,PRY,2012,0,0,0,8441,0,0,8441
Paraguay,PRY,2013,0,0,0,0,0,0,0
Paraguay,PRY,2016,0,0,0,0,0,0,0
Paraguay,PRY,1965,0,27996,0,0,0,0,27996
Paraguay,PRY,1966,0,0,0,0,0,0,0
Paraguay,PRY,1971,0,0,0,0,0,0,0
Paraguay,PRY,1979,0,0,0,0,0,0,0
Paraguay,PRY,1982,0,0,0,0,0,0,0
Paraguay,PRY,1988,0,0,0,0,0,0,0
Paraguay,PRY,1990,0,0,0,0,0,0,0
Paraguay,PRY,1992,0,0,0,0,0,0,0
Paraguay,PRY,1995,0,0,0,0,0,0,0
Paraguay,PRY,1997,0,0,0,68489,0,0,68489
Paraguay,PRY,1998,0,111710,0,0,0,0,111710
Paraguay,PRY,2002,0,0,0,0,0,0,0
Paraguay,PRY,2014,0,0,0,0,0,0,0
Paraguay,PRY,2015,0,19424,0,3237,0,0,22661
Paraguay,PRY,2018,0,0,0,0,0,0,0
Paraguay,PRY,2019,0,61255,0,0,0,0,61255
Paraguay,PRY,2021,0,14917,0,0,0,0,14917
Paraguay,PRY,2023,0,0,0,0,0,0,0
Paraguay,PRY,2011,0,0,0,0,0,0,0
Paraguay,PRY,2000,0,0,0,0,15613,0,15613
Paraguay,PRY,2004,0,0,0,0,0,0,0
Paraguay,PRY,2010,0,0,0,0,20802,0,20802
Paraguay,PRY,2007,0,0,0,0,0,14311,14311
Peru,PER,1966,0,0,98945,0,0,0,98945
Peru,PER,1969,0,0,113518,0,0,0,113518
Peru,PER,1983,0,0,5312,0,9030,316568,330910
Peru,PER,1990,0,27590,90460,0,0,14926,132976
Peru,PER,1992,0,0,0,0,0,0,0
Peru,PER,2002,0,8414,0,21584,0,0,29998
Peru,PER,2004,0,0,0,0,32265,3944,36209
Peru,PER,2006,0,0,0,0,0,0,0
Peru,PER,1965,0,50927,0,0,0,0,50927
Peru,PER,1967,0,20029,0,0,0,0,20029
Peru,PER,1970,0,2212,49279727,0,0,0,49281939
Peru,PER,1971,0,179701,0,0,0,431283,610984
Peru,PER,1977,0,12943,0,0,0,0,12943
Peru,PER,1978,0,1202,0,0,0,0,1202
Peru,PER,1980,0,40017,4002,0,0,0,44019
Peru,PER,1981,0,39036,10038,0,0,39036,88110
Peru,PER,1982,0,180686,1633,0,0,108847,291166
Peru,PER,1986,0,30680,7917,0,0,19794,58391
Peru,PER,1987,0,83691,0,0,0,45957,129648
Peru,PER,1988,0,17972,0,0,0,37836,55808
Peru,PER,1989,0,17573,0,0,0,0,17573
Peru,PER,1993,0,34022,2552,0,0,0,36574
Peru,PER,1994,0,35441,0,0,0,0,35441
Peru,PER,1999,0,28188,381,0,0,15237,43806
Peru,PER,2000,0,8254,0,0,0,4127,12381
Peru,PER,2001,0,5552,55895,0,0,7403,68850
Peru,PER,2003,0,7964,0,0,122722,0,130686
Peru,PER,2007,0,5944,207340,0,23426,0,236710
Peru,PER,2008,0,13886,0,0,0,0,13886
Peru,PER,2009,0,54465,0,0,94452,49984,198901
Peru,PER,2010,0,6842,0,0,139927,23264,170033
Peru,PER,2011,0,24425,339,5428,6785,0,36977
Peru,PER,2012,0,4706,0,0,84707,7395,96808
Peru,PER,2013,0,22637,0,0,333,0,22970
Peru,PER,2014,0,13507,2636,0,166370,0,182513
Peru,PER,2015,0,2930,0,0,6838,0,9768
Peru,PER,2016,0,642,1606,0,0,0,2248
Peru,PER,2017,0,63280,0,0,0,0,63280
Peru,PER,2019,0,18583,609,0,0,4570,23762
Peru,PER,2020,0,4504,0,0,0,4504,9008
Peru,PER,2021,0,6822,0,0,0,0,6822
Peru,PER,2022,0,294,0,0,0,3524,3818
Peru,PER,2023,0,27945,291,2329,0,11062,41627
Peru,PER,1913,0,0,349136,0,0,0,349136
Peru,PER,1914,0,0,78151,0,0,0,78151
Peru,PER,1939,0,0,58363,0,0,0,58363
Peru,PER,1940,0,0,277735,0,0,0,277735
Peru,PER,1942,0,0,45015,0,0,0,45015
Peru,PER,1943,0,0,295045,0,0,0,295045
Peru,PER,1946,0,0,1962691,0,0,0,1962691
Peru,PER,1947,0,0,321145,0,0,0,321145
Peru,PER,1950,0,0,108087,0,0,169294,277381
Peru,PER,1953,0,0,10779,0,0,0,10779
Peru,PER,1958,0,0,29159,0,0,0,29159
Peru,PER,1960,0,0,61933,0,0,0,61933
Peru,PER,1968,0,0,8565,0,0,0,8565
Peru,PER,1972,0,0,8396,0,0,0,8396
Peru,PER,1974,0,0,58444,0,0,205882,264326
Peru,PER,1979,0,0,7621,0,0,0,7621
Peru,PER,1985,0,0,0,0,0,75962,75962
Peru,PER,1991,0,0,28340,0,11070,0,39410
Peru,PER,1996,0,0,8431,0,0,0,8431
Peru,PER,2005,0,0,1776,0,0,0,1776
Peru,PER,2018,0,0,621,0,0,0,621
Peru,PER,1962,0,0,0,55596,0,1891198,1946794
Peru,PER,1997,0,0,0,204215,0,118271,322486
Peru,PER,1941,0,0,0,0,0,7629802,7629802
Peru,PER,1973,0,0,0,0,0,340720,340720
Peru,PER,1984,0,0,0,0,0,3630,3630
Peru,PER,1995,0,0,0,0,0,8180,8180
Peru,PER,1998,0,0,0,0,0,17430,17430
Philippines,PHL,1978,0,11549,0,134450,0,4794,150793
Philippines,PHL,1980,0,413,0,43784,0,10326,54523
Philippines,PHL,1983,0,2106,3638,24512,0,0,30256
Philippines,PHL,1987,0,0,0,190542,0,0,190542
Philippines,PHL,1990,0,28591,392632,119723,0,0,540946
Philippines,PHL,1998,1074,0,0,79740,0,268,81082
Philippines,PHL,2002,0,11072,1845,26450,0,0,39367
Philippines,PHL,2007,0,4466,0,8709,0,0,13175
Philippines,PHL,2015,0,5144,0,14365,0,0,19509
Philippines,PHL,2019,0,0,7972,8335,0,0,16307
Philippines,PHL,1968,0,8159,76241,14067,0,844,99311
Philippines,PHL,1972,0,165684,0,110371,0,0,276055
Philippines,PHL,1973,0,742,3465,85630,0,0,89837
Philippines,PHL,1974,0,22712,0,49048,0,0,71760
Philippines,PHL,1975,0,0,0,9199,0,0,9199
Philippines,PHL,1976,0,4140,1380123,89018,0,0,1473281
Philippines,PHL,1977,0,5376,224,23294,0,0,28894
Philippines,PHL,1979,0,0,0,13148,0,0,13148
Philippines,PHL,1981,0,71056,0,201090,0,40258,312404
Philippines,PHL,1982,0,6478,0,110525,0,0,117003
Philippines,PHL,1985,0,14413,365,33934,0,54732,103444
Philippines,PHL,1986,0,535,0,31367,0,0,31902
Philippines,PHL,1989,0,7318,0,62867,0,16465,86650
Philippines,PHL,1991,0,11104,0,964947,0,101523,1077574
Philippines,PHL,1992,0,12240,0,15648,0,0,27888
Philippines,PHL,1993,0,8020,0,78386,0,15132,101538
Philippines,PHL,1994,0,9165,11973,36659,0,3991,61788
Philippines,PHL,1995,0,68736,0,180360,0,0,249096
Philippines,PHL,1996,0,0,0,5356,0,6343,11699
Philippines,PHL,1997,0,2475,0,6738,0,0,9213
Philippines,PHL,1999,0,21508,787,13115,0,13115,48525
Philippines,PHL,2000,0,7055,0,50540,0,38226,95821
Philippines,PHL,2001,0,5400,0,73720,0,0,79120
Philippines,PHL,2003,0,0,0,11454,0,30744,42198
Philippines,PHL,2004,0,5791,0,219957,0,946,226694
Philippines,PHL,2005,0,580,0,3942,0,0,4522
Philippines,PHL,2006,0,4095,0,205343,0,130031,339469
Philippines,PHL,2008,0,12712,0,89751,0,2630,105093
Philippines,PHL,2009,0,5917,0,133625,0,1076,140618
Philippines,PHL,2010,0,17118,0,22401,0,211,39730
Philippines,PHL,2011,0,12664,0,184974,0,3010,200648
Philippines,PHL,2012,0,16015,11629,207993,0,7651,243288
Philippines,PHL,2013,0,10532,23069,743730,0,0,777331
Philippines,PHL,2014,0,493,0,32174,0,0,32667
Philippines,PHL,2016,0,4291,763,3242,0,0,8296
Philippines,PHL,2017,0,2061,1031,18737,0,0,21829
Philippines,PHL,2018,0,1013,0,27816,0,0,28829
Philippines,PHL,2021,0,439,0,49789,0,0,50228
Philippines,PHL,2022,0,6317,865,45085,0,433,52700
Philippines,PHL,2023,0,5795,0,4091,0,0,9886
Philippines,PHL,1918,0,0,111255,0,0,0,111255
Philippines,PHL,1925,0,0,16412,0,0,0,16412
Philippines,PHL,1937,0,0,742,171302,0,0,172044
Philippines,PHL,1948,0,0,41066,0,0,0,41066
Philippines,PHL,1954,0,0,5902,0,0,0,5902
Philippines,PHL,1955,0,0,173702,62533,0,0,236235
Philippines,PHL,1960,0,0,11233,221506,0,14042,246781
Philippines,PHL,1970,0,0,3740,1015611,0,0,1019351
Philippines,PHL,2020,0,0,89,16935,0,980,18004
Philippines,PHL,1905,0,0,0,333271,0,0,333271
Philippines,PHL,1912,0,0,0,0,0,0,0
Philippines,PHL,1931,0,0,0,0,0,0,0
Philippines,PHL,1932,0,0,0,122219,0,0,122219
Philippines,PHL,1934,0,0,0,67510,0,0,67510
Philippines,PHL,1936,0,0,0,392261,0,0,392261
Philippines,PHL,1938,0,0,0,221063,0,0,221063
Philippines,PHL,1940,0,0,0,50502,0,0,50502
Philippines,PHL,1946,0,0,0,155657,0,0,155657
Philippines,PHL,1949,0,0,0,556036,0,0,556036
Philippines,PHL,1951,0,0,0,420701,0,259052,679753
Philippines,PHL,1952,0,0,0,502780,0,0,502780
Philippines,PHL,1956,0,0,0,53573,0,0,53573
Philippines,PHL,1957,0,0,0,35351,0,0,35351
Philippines,PHL,1959,0,0,0,10561,0,0,10561
Philippines,PHL,1962,0,0,0,65262,0,0,65262
Philippines,PHL,1963,0,0,0,322,0,0,322
Philippines,PHL,1964,0,0,0,199269,0,0,199269
Philippines,PHL,1965,0,0,0,11279,0,108213,119492
Philippines,PHL,1966,0,0,0,5340,0,0,5340
Philippines,PHL,1967,0,0,0,30910,0,0,30910
Philippines,PHL,1969,0,0,0,3016,0,0,3016
Philippines,PHL,1971,0,0,0,64026,0,0,64026
Philippines,PHL,1984,0,0,0,500608,0,0,500608
Philippines,PHL,1988,0,0,0,134114,0,9191,143305
Philippines,PHL,1911,0,0,0,0,0,1675263,1675263
Philippines,PHL,1950,0,0,0,0,0,45479,45479
Poland,POL,2018,0,0,0,0,2336,0,2336
Poland,POL,1977,0,0,0,0,0,0,0
Poland,POL,1980,0,0,0,0,0,0,0
Poland,POL,1982,0,0,0,0,0,0,0
Poland,POL,1987,0,0,0,0,0,0,0
Poland,POL,1997,0,14324,0,0,13022,0,27346
Poland,POL,1998,0,2345,0,0,16675,0,19020
Poland,POL,2001,0,6983,0,0,69834,0,76817
Poland,POL,2004,0,0,0,0,0,0,0
Poland,POL,2005,0,518,0,0,49513,0,50031
Poland,POL,2006,0,0,0,0,0,0,0
Poland,POL,2009,0,259,0,2075,77292,0,79626
Poland,POL,2010,0,4923,0,0,51817,0,56740
Poland,POL,2016,0,519,0,0,5450,0,5969
Poland,POL,2020,0,0,0,781,0,0,781
Poland,POL,2021,0,0,0,1044,0,0,1044
Poland,POL,1928,0,0,0,30744,0,0,30744
Poland,POL,1983,0,0,0,0,0,0,0
Poland,POL,1990,0,0,0,0,0,0,0
Poland,POL,1994,0,0,0,261,0,0,261
Poland,POL,1999,0,0,0,782,40151,0,40933
Poland,POL,2002,0,0,0,2329,47351,0,49680
Poland,POL,2007,0,0,0,4932,0,0,4932
Poland,POL,2008,0,0,0,519,21286,0,21805
Poland,POL,2012,0,0,0,259,70678,0,70937
Poland,POL,2013,0,0,0,1036,6475,0,7511
Poland,POL,2015,0,0,0,259,19972,0,20231
Poland,POL,2017,0,0,0,1557,0,0,1557
Poland,POL,2019,0,0,0,1039,0,0,1039
Poland,POL,2022,0,0,0,1756,191434,0,193190
Poland,POL,2000,0,0,0,0,21816,0,21816
Poland,POL,2011,0,0,0,0,6732,0,6732
Poland,POL,2014,0,0,0,0,20217,0,20217
Poland,POL,1992,0,0,0,0,0,9150,9150
Portugal,PRT,1983,0,19107,0,0,0,0,19107
Portugal,PRT,1997,0,0,0,28626,0,28626,57252
Portugal,PRT,2004,0,0,0,0,0,1904,1904
Portugal,PRT,2022,0,0,0,0,2153667,2921,2156588
Portugal,PRT,1967,0,521642,0,0,0,0,521642
Portugal,PRT,1979,0,23745,0,0,0,0,23745
Portugal,PRT,1981,0,30436,0,0,0,0,30436
Portugal,PRT,1996,0,9913,0,0,0,0,9913
Portugal,PRT,2001,0,5785,0,0,0,0,5785
Portugal,PRT,2002,0,959,0,0,0,0,959
Portugal,PRT,2003,0,0,0,0,2574154,13367,2587521
Portugal,PRT,2006,0,0,0,0,38885,0,38885
Portugal,PRT,2008,0,1890,0,0,0,0,1890
Portugal,PRT,2010,0,40610,0,2833,0,0,43443
Portugal,PRT,2015,0,965,0,0,0,0,965
Portugal,PRT,1909,0,0,51549,0,0,0,51549
Portugal,PRT,1964,0,0,0,0,0,0,0
Portugal,PRT,1969,0,0,2281,0,0,0,2281
Portugal,PRT,1980,0,0,70514,0,0,0,70514
Portugal,PRT,1998,0,0,9824,0,0,0,9824
Portugal,PRT,1941,0,0,0,155170,0,0,155170
Portugal,PRT,1946,0,0,0,33270,0,0,33270
Portugal,PRT,1973,0,0,0,12280,0,0,12280
Portugal,PRT,1989,0,0,0,0,0,0,0
Portugal,PRT,2000,0,0,0,3883,0,0,3883
Portugal,PRT,2013,0,0,0,956,0,8600,9556
Portugal,PRT,2014,0,0,0,961,0,0,961
Portugal,PRT,2018,0,0,0,1944,0,0,1944
Portugal,PRT,2019,0,0,0,1944,0,0,1944
Portugal,PRT,2005,0,0,0,0,439025,14254,453279
Portugal,PRT,1966,0,0,0,0,0,28147,28147
Portugal,PRT,1985,0,0,0,0,0,14004,14004
Portugal,PRT,1986,0,0,0,0,0,14983,14983
Portugal,PRT,1991,0,0,0,0,0,0,0
Portugal,PRT,2016,0,0,0,0,0,3871,3871
Portugal,PRT,2017,0,0,0,0,0,105748,105748
Portugal,PRT,2023,0,0,0,0,0,0,0
Puerto Rico,PRI,1994,0,0,0,0,0,0,0
Puerto Rico,PRI,1970,0,219168,0,0,0,0,219168
Puerto Rico,PRI,1985,0,1467878,0,0,0,293576,1761454
Puerto Rico,PRI,1992,0,49825,0,0,0,0,49825
Puerto Rico,PRI,2001,0,5219,0,0,0,0,5219
Puerto Rico,PRI,2003,0,5228,0,0,0,0,5228
Puerto Rico,PRI,2004,0,0,0,5240,0,0,5240
Puerto Rico,PRI,2014,0,2809,0,0,0,0,2809
Puerto Rico,PRI,2018,0,0,0,0,0,0,0
Puerto Rico,PRI,2022,0,0,0,76866,0,0,76866
Puerto Rico,PRI,2020,0,0,12227,3057,0,0,15284
Puerto Rico,PRI,1960,0,0,0,0,0,0,0
Puerto Rico,PRI,1975,0,0,0,87475,0,0,87475
Puerto Rico,PRI,1979,0,0,0,9475,0,0,9475
Puerto Rico,PRI,1989,0,0,0,0,0,0,0
Puerto Rico,PRI,1995,0,0,0,2699,0,0,2699
Puerto Rico,PRI,1996,0,0,0,48221,0,0,48221
Puerto Rico,PRI,1998,0,0,0,0,0,0,0
Puerto Rico,PRI,1999,0,0,0,2625,0,0,2625
Puerto Rico,PRI,2007,0,0,0,2649,0,0,2649
Puerto Rico,PRI,2011,0,0,0,2709,0,0,2709
Puerto Rico,PRI,2012,0,0,0,0,0,0,0
Puerto Rico,PRI,2017,0,0,0,196055,0,0,196055
Puerto Rico,PRI,1981,0,0,0,0,0,79768,79768
Qatar,QAT,2018,0,0,0,0,0,0,0
Réunion,REU,1980,0,0,0,453164,0,181265,634429
Réunion,REU,1984,0,0,0,0,0,0,0
Réunion,REU,1987,0,0,0,160701,0,0,160701
Réunion,REU,1989,0,0,0,154770,0,0,154770
Réunion,REU,1993,0,0,0,199974,0,0,199974
Réunion,REU,2000,0,0,0,25464,0,0,25464
Réunion,REU,2002,0,0,0,0,0,0,0
Réunion,REU,2007,0,0,0,23239,0,0,23239
Réunion,REU,2014,0,0,0,10931,0,0,10931
Réunion,REU,2018,0,0,0,0,0,0,0
Réunion,REU,2022,0,0,0,0,0,0,0
Réunion,REU,2023,0,0,0,0,0,0,0
Réunion,REU,1977,0,0,0,0,0,0,0
Romania,ROU,1983,0,0,0,0,0,0,0
Romania,ROU,2000,0,4106,0,6387,2737,0,13230
Romania,ROU,1926,0,747215,0,0,0,0,747215
Romania,ROU,1970,0,107918,0,0,0,0,107918
Romania,ROU,1975,0,28346,0,0,0,0,28346
Romania,ROU,1984,0,0,0,0,0,0,0
Romania,ROU,1991,0,47280,0,0,0,0,47280
Romania,ROU,1994,0,884,0,0,0,0,884
Romania,ROU,1995,0,888,0,0,0,0,888
Romania,ROU,1997,0,8973,0,5384,0,0,14357
Romania,ROU,1998,0,13988,0,0,36099,0,50087
Romania,ROU,1999,0,15427,0,0,0,0,15427
Romania,ROU,2001,0,3211,0,0,4588,0,7799
Romania,ROU,2002,0,4156,0,0,4618,0,8774
Romania,ROU,2003,0,1397,0,0,0,0,1397
Romania,ROU,2004,0,4697,0,5637,12682,0,23016
Romania,ROU,2005,0,37454,0,1422,38403,0,77279
Romania,ROU,2006,0,24391,0,0,12435,0,36826
Romania,ROU,2007,0,5785,0,0,32780,0,38565
Romania,ROU,2008,0,2427,0,0,20876,0,23303
Romania,ROU,2009,0,5375,0,0,5375,0,10750
Romania,ROU,2010,0,12786,0,0,25571,0,38357
Romania,ROU,2013,0,4485,0,0,0,0,4485
Romania,ROU,2014,0,2000,0,0,6501,0,8501
Romania,ROU,2015,0,502,0,0,0,0,502
Romania,ROU,2016,0,1515,0,0,0,0,1515
Romania,ROU,2018,0,0,0,0,1020,0,1020
Romania,ROU,2019,0,2049,0,0,0,0,2049
Romania,ROU,2020,0,1543,0,0,0,0,1543
Romania,ROU,2021,0,517,0,0,0,0,517
Romania,ROU,1908,0,0,0,0,0,0,0
Romania,ROU,1913,0,0,0,0,0,0,0
Romania,ROU,1928,0,0,0,4363,0,0,4363
Romania,ROU,1934,0,0,0,0,0,0,0
Romania,ROU,1940,0,0,619964,0,0,0,619964
Romania,ROU,1945,0,0,0,0,0,0,0
Romania,ROU,1977,0,0,756964,0,0,0,756964
Romania,ROU,1990,0,0,3941,0,0,0,3941
Romania,ROU,1993,0,0,0,1320,0,0,1320
Romania,ROU,2017,0,0,0,4569,0,0,4569
Romania,ROU,2023,0,0,0,1005,0,0,1005
Romania,ROU,1996,0,0,0,0,7137,0,7137
Romania,ROU,2012,0,0,0,0,42707,0,42707
Romania,ROU,2022,0,0,0,0,1248775,0,1248775
Russia,RUS,1993,0,9268,0,0,2754,20081,32103
Russia,RUS,1998,0,948,0,542,4672,203,6365
Russia,RUS,2003,0,0,207,0,0,0,207
Russia,RUS,2010,0,1606,0,0,3892697,4259,3898562
Russia,RUS,2012,0,12463,0,0,16292,139,28894
Russia,RUS,1992,0,0,0,0,0,2084,2084
Russia,RUS,1994,0,3091,739,806,2822,0,7458
Russia,RUS,1996,0,270,0,0,0,1282,1552
Russia,RUS,1997,0,135,0,0,1487,946,2568
Russia,RUS,1999,0,0,68,814,10995,0,11877
Russia,RUS,2000,0,204,0,613,16684,1839,19340
Russia,RUS,2001,0,2530,0,547,51492,0,54569
Russia,RUS,2002,0,13737,0,549,16622,8380,39288
Russia,RUS,2004,0,1247,0,623,0,623,2493
Russia,RUS,2005,0,1530,0,0,8067,626,10223
Russia,RUS,2006,0,0,0,0,0,0,0
Russia,RUS,2007,0,0,140,0,0,0,140
Russia,RUS,2011,0,0,0,70,0,0,70
Russia,RUS,2013,0,278,0,0,0,0,278
Russia,RUS,2014,0,416,0,0,0,0,416
Russia,RUS,2015,0,69,0,0,0,2074,2143
Russia,RUS,2016,0,0,0,0,0,0,0
Russia,RUS,2017,0,0,0,1100,0,0,1100
Russia,RUS,2018,0,687,0,0,0,0,687
Russia,RUS,2019,0,4048,0,0,0,0,4048
Russia,RUS,2021,0,551,0,0,0,414,965
Russia,RUS,2022,0,69,0,415,0,1106,1590
Russia,RUS,1995,0,0,133888,9761,15348,1144,160141
Russia,RUS,2008,0,0,909,0,0,0,909
Russia,RUS,2023,0,0,0,900,0,1454,2354
Rwanda,RWA,1976,0,0,0,0,0,0,0
Rwanda,RWA,1984,0,0,0,0,0,0,0
Rwanda,RWA,1989,331841,0,0,0,0,0,331841
Rwanda,RWA,1996,0,0,0,0,0,0,0
Rwanda,RWA,1999,0,0,0,0,0,0,0
Rwanda,RWA,2003,0,0,0,0,0,0,0
Rwanda,RWA,1974,0,0,0,0,0,0,0
Rwanda,RWA,1988,0,69025,0,0,0,0,69025
Rwanda,RWA,2001,0,14592,0,0,0,0,14592
Rwanda,RWA,2002,0,82415,53749,0,0,0,136164
Rwanda,RWA,2007,0,31502,0,0,0,0,31502
Rwanda,RWA,2008,0,0,36802,0,0,0,36802
Rwanda,RWA,2011,0,13236,0,0,0,0,13236
Rwanda,RWA,2012,0,4612,0,0,0,0,4612
Rwanda,RWA,2015,0,1718,0,0,0,0,1718
Rwanda,RWA,2016,0,56157,0,0,0,41908,98065
Rwanda,RWA,2018,0,46282,0,0,0,14363,60645
Rwanda,RWA,2019,0,21815,0,0,0,0,21815
Rwanda,RWA,2020,0,84434,0,0,0,0,84434
Rwanda,RWA,2021,0,0,0,0,0,0,0
Rwanda,RWA,2022,0,21050,0,0,0,0,21050
Rwanda,RWA,2023,0,92943,0,0,0,0,92943
Rwanda,RWA,2017,0,0,0,2453,0,0,2453
Rwanda,RWA,2006,0,0,0,0,0,25890,25890
Rwanda,RWA,2010,0,0,0,0,0,20370,20370
Saint Helena,SHN,2001,0,0,0,0,0,0,0
Saint Kitts and Nevis,KNA,1987,0,0,0,0,0,0,0
Saint Kitts and Nevis,KNA,1928,0,0,0,0,0,0,0
Saint Kitts and Nevis,KNA,1955,0,0,0,0,0,0,0
Saint Kitts and Nevis,KNA,1984,0,0,0,0,0,0,0
Saint Kitts and Nevis,KNA,1989,0,0,0,243813,0,0,243813
Saint Kitts and Nevis,KNA,1990,0,0,0,0,0,0,0
Saint Kitts and Nevis,KNA,1995,0,0,0,0,0,0,0
Saint Kitts and Nevis,KNA,1998,0,0,0,1129790,0,0,1129790
Saint Kitts and Nevis,KNA,1999,0,0,0,0,0,0,0
Saint Kitts and Nevis,KNA,2008,0,0,0,0,0,0,0
Saint Kitts and Nevis,KNA,2017,0,0,0,0,0,0,0
Saint Lucia,LCA,2010,0,0,0,818953,0,0,818953
Saint Lucia,LCA,2013,0,344843,0,0,0,0,344843
Saint Lucia,LCA,2022,0,0,0,0,0,0,0
Saint Lucia,LCA,2007,0,0,0,59693,0,0,59693
Saint Lucia,LCA,1960,0,0,0,0,0,0,0
Saint Lucia,LCA,1963,0,0,0,1053685,0,0,1053685
Saint Lucia,LCA,1967,0,0,0,0,0,0,0
Saint Lucia,LCA,1980,0,0,0,739821,0,0,739821
Saint Lucia,LCA,1983,0,0,0,0,0,0,0
Saint Lucia,LCA,1986,0,0,0,0,0,0,0
Saint Lucia,LCA,1987,0,0,0,0,0,0,0
Saint Lucia,LCA,1988,0,0,0,0,0,0,0
Saint Lucia,LCA,1994,0,0,0,265650,0,0,265650
Saint Lucia,LCA,1999,0,0,0,0,0,0,0
Saint Lucia,LCA,2004,0,0,0,0,0,0,0
Saint Lucia,LCA,2016,0,0,0,0,0,0,0
Saint Lucia,LCA,2021,0,0,0,55660,0,0,55660
Saint Lucia,LCA,1996,0,0,0,0,0,0,0
Saint Vincent and the Grenadines,VCT,2010,0,0,0,0,0,0,0
Saint Vincent and the Grenadines,VCT,1977,0,0,0,0,0,0,0
Saint Vincent and the Grenadines,VCT,1986,0,0,0,0,0,0,0
Saint Vincent and the Grenadines,VCT,1987,0,0,0,0,0,0,0
Saint Vincent and the Grenadines,VCT,1992,0,264936,0,0,0,0,264936
Saint Vincent and the Grenadines,VCT,2011,0,0,0,0,0,0,0
Saint Vincent and the Grenadines,VCT,2013,0,1116601,0,0,0,0,1116601
Saint Vincent and the Grenadines,VCT,2016,0,0,0,94365,0,0,94365
Saint Vincent and the Grenadines,VCT,1955,0,0,0,16982892,0,0,16982892
Saint Vincent and the Grenadines,VCT,1967,0,0,0,211860,0,0,211860
Saint Vincent and the Grenadines,VCT,1980,0,0,0,0,0,0,0
Saint Vincent and the Grenadines,VCT,1999,0,0,0,0,0,0,0
Saint Vincent and the Grenadines,VCT,2002,0,0,0,352529,0,0,352529
Saint Vincent and the Grenadines,VCT,2004,0,0,0,0,0,0,0
Saint Vincent and the Grenadines,VCT,2005,0,0,0,0,0,0,0
Saint Vincent and the Grenadines,VCT,2021,0,0,0,0,0,0,0
Saint Vincent and the Grenadines,VCT,2023,0,0,0,0,0,0,0
Saint Vincent and the Grenadines,VCT,1902,0,0,0,0,0,357338570,357338570
Saint Vincent and the Grenadines,VCT,1971,0,0,0,0,0,0,0
Saint Vincent and the Grenadines,VCT,1979,0,0,0,0,0,187098,187098
Samoa,WSM,2015,0,0,0,0,0,0,0
Samoa,WSM,2001,0,0,0,0,0,0,0
Samoa,WSM,2009,0,0,7660892,0,0,0,7660892
Samoa,WSM,1964,0,0,0,19747080,0,0,19747080
Samoa,WSM,1966,0,0,0,751931,0,0,751931
Samoa,WSM,1968,0,0,0,0,0,0,0
Samoa,WSM,1983,0,0,0,0,0,0,0
Samoa,WSM,1989,0,0,0,0,0,0,0
Samoa,WSM,1990,0,0,0,475619,0,0,475619
Samoa,WSM,1991,0,0,0,770539,0,0,770539
Samoa,WSM,2004,0,0,0,53168,0,0,53168
Samoa,WSM,2005,0,0,0,477114,0,0,477114
Samoa,WSM,2012,0,0,0,605660,0,0,605660
Samoa,WSM,2018,0,0,0,0,0,0,0
São Tomé and Príncipe,STP,1983,0,0,0,0,0,0,0
São Tomé and Príncipe,STP,2021,0,358555,0,0,0,0,358555
Saudi Arabia,SAU,1964,0,41709,0,0,0,0,41709
Saudi Arabia,SAU,1985,0,24825,0,0,0,0,24825
Saudi Arabia,SAU,2002,0,8398,0,0,0,0,8398
Saudi Arabia,SAU,2003,0,5183,0,0,0,0,5183
Saudi Arabia,SAU,2004,0,2113,0,0,0,0,2113
Saudi Arabia,SAU,2005,0,25822,0,0,0,0,25822
Saudi Arabia,SAU,2009,0,56523,0,0,0,0,56523
Saudi Arabia,SAU,2010,0,8160,0,0,0,0,8160
Saudi Arabia,SAU,2011,0,3648,0,0,0,0,3648
Saudi Arabia,SAU,2012,0,6165,0,0,0,0,6165
Saudi Arabia,SAU,2013,0,12388,0,0,0,0,12388
Saudi Arabia,SAU,2015,0,7023,0,0,0,0,7023
Saudi Arabia,SAU,2016,0,6284,0,898,0,0,7182
Saudi Arabia,SAU,2017,0,1170,0,0,0,0,1170
Saudi Arabia,SAU,2019,0,5582,0,0,0,0,5582
Saudi Arabia,SAU,2020,0,833,0,0,0,0,833
Saudi Arabia,SAU,1982,0,0,0,0,0,0,0
Senegal,SEN,1910,0,0,0,0,0,0,0
Senegal,SEN,1940,0,0,0,0,0,0,0
Senegal,SEN,1966,0,0,0,0,0,0,0
Senegal,SEN,1969,0,0,0,0,0,0,0
Senegal,SEN,1976,0,0,0,0,0,0,0
Senegal,SEN,1979,0,0,0,0,0,0,0
Senegal,SEN,1980,0,0,0,0,0,0,0
Senegal,SEN,2002,0,27502,0,0,0,0,27502
Senegal,SEN,2011,0,0,0,0,0,0,0
Senegal,SEN,2014,0,0,0,0,0,0,0
Senegal,SEN,2018,0,0,0,0,0,0,0
Senegal,SEN,1978,0,0,0,0,0,0,0
Senegal,SEN,1983,0,0,0,0,0,0,0
Senegal,SEN,1985,0,0,0,0,0,0,0
Senegal,SEN,1988,0,0,0,0,0,0,0
Senegal,SEN,1993,0,0,0,0,0,0,0
Senegal,SEN,1994,0,0,0,0,0,0,0
Senegal,SEN,1998,0,0,0,0,0,0,0
Senegal,SEN,2000,0,0,0,0,0,0,0
Senegal,SEN,2003,0,7667,0,0,0,0,7667
Senegal,SEN,2005,0,0,0,0,0,0,0
Senegal,SEN,2007,0,6918,0,0,0,0,6918
Senegal,SEN,2008,0,842,0,0,0,0,842
Senegal,SEN,2009,0,4920,0,0,0,0,4920
Senegal,SEN,2010,0,1596,0,0,0,0,1596
Senegal,SEN,2012,0,14359,0,0,0,0,14359
Senegal,SEN,2013,0,5884,0,0,0,0,5884
Senegal,SEN,2016,0,3390,0,0,0,0,3390
Senegal,SEN,2019,0,3750,0,0,0,0,3750
Senegal,SEN,2020,0,6693,0,0,0,0,6693
Senegal,SEN,2022,0,0,0,0,0,0,0
Senegal,SEN,1999,0,0,0,197287,0,0,197287
Senegal,SEN,2004,0,0,0,1869,0,0,1869
Serbia,SRB,2007,0,0,0,0,0,0,0
Serbia,SRB,2009,0,0,0,0,0,0,0
Serbia,SRB,2010,0,2613,2613,0,6533,0,11759
Serbia,SRB,2013,0,0,0,0,0,0,0
Serbia,SRB,2014,0,74232,0,0,0,0,74232
Serbia,SRB,2016,0,0,0,0,0,0,0
Serbia,SRB,2018,0,0,0,0,0,0,0
Serbia,SRB,2019,0,0,0,0,0,0,0
Serbia,SRB,2020,0,0,0,0,0,0,0
Serbia,SRB,2021,0,0,0,0,0,0,0
Serbia,SRB,2023,0,2798,0,1399,0,0,4197
Serbia,SRB,2012,0,0,0,0,32932,0,32932
Serbia,SRB,2017,0,0,0,0,8038,0,8038
Serbia,SRB,2022,0,0,0,0,794864,0,794864
Seychelles,SYC,1997,0,653134,0,0,0,0,653134
Seychelles,SYC,2014,0,0,0,0,0,0,0
Seychelles,SYC,2004,0,0,354053,0,0,0,354053
Seychelles,SYC,2002,0,0,0,0,0,0,0
Seychelles,SYC,2013,0,0,0,0,0,0,0
Sierra Leone,SLE,1996,0,27603,0,0,0,0,27603
Sierra Leone,SLE,2004,0,18072,0,0,0,0,18072
Sierra Leone,SLE,2005,0,35191,0,0,0,0,35191
Sierra Leone,SLE,2007,0,0,0,0,0,0,0
Sierra Leone,SLE,2009,0,164541,0,0,0,0,164541
Sierra Leone,SLE,2010,0,0,0,0,0,24857,24857
Sierra Leone,SLE,2011,0,31759,0,0,0,0,31759
Sierra Leone,SLE,2015,0,13671,0,0,0,0,13671
Sierra Leone,SLE,2019,0,8699,0,0,0,0,8699
Sierra Leone,SLE,2022,0,13944,0,0,0,0,13944
Sierra Leone,SLE,1975,0,0,0,3272,0,0,3272
Sierra Leone,SLE,1984,0,0,0,163654,0,0,163654
Sierra Leone,SLE,1999,0,0,0,29049,0,0,29049
Sierra Leone,SLE,2023,0,0,0,17063,0,0,17063
Sierra Leone,SLE,2017,0,0,0,0,0,1435350,1435350
Sierra Leone,SLE,2013,0,0,0,0,0,0,0
Slovakia,SVK,1997,0,0,0,0,0,0,0
Slovakia,SVK,1998,0,100538,0,0,0,0,100538
Slovakia,SVK,1999,0,3721,0,0,0,0,3721
Slovakia,SVK,2001,0,1860,0,0,0,0,1860
Slovakia,SVK,2002,0,0,0,0,0,0,0
Slovakia,SVK,2004,0,1860,0,3721,0,0,5581
Slovakia,SVK,2005,0,1860,0,0,0,0,1860
Slovakia,SVK,2006,0,1860,0,0,0,0,1860
Slovakia,SVK,2010,0,7412,0,0,226075,0,233487
Slovakia,SVK,2013,0,1847,0,0,0,0,1847
Slovakia,SVK,2020,0,1833,0,0,0,0,1833
Slovakia,SVK,2021,0,1836,0,0,0,0,1836
Slovakia,SVK,2017,0,0,0,0,0,0,0
Slovakia,SVK,2019,0,0,0,1834,0,0,1834
Slovakia,SVK,2023,0,0,0,0,0,0,0
Slovakia,SVK,2003,0,0,0,0,0,0,0
Slovakia,SVK,2007,0,0,0,0,1859,0,1859
Slovakia,SVK,2012,0,0,0,0,9243,0,9243
Slovakia,SVK,2022,0,0,0,0,646767,0,646767
Slovakia,SVK,2000,0,0,0,0,0,11159,11159
Slovenia,SVN,2005,0,0,0,0,0,0,0
Slovenia,SVN,2012,0,0,0,0,0,0,0
Slovenia,SVN,2014,0,14458,0,0,4819,0,19277
Slovenia,SVN,2021,0,0,0,0,0,0,0
Slovenia,SVN,1998,0,0,0,0,0,0,0
Slovenia,SVN,2004,0,0,5008,0,0,0,5008
Slovenia,SVN,2007,0,0,0,29656,0,0,29656
Slovenia,SVN,2020,0,0,0,4722,0,0,4722
Slovenia,SVN,2023,0,0,0,4718,0,0,4718
Slovenia,SVN,2003,0,0,0,0,1452690,0,1452690
Slovenia,SVN,2022,0,0,0,0,726469,0,726469
Solomon Islands,SLB,1997,0,0,0,0,0,0,0
Solomon Islands,SLB,1998,0,0,0,0,0,0,0
Solomon Islands,SLB,2015,0,0,0,146898,0,0,146898
Solomon Islands,SLB,2009,0,397845,0,0,0,0,397845
Solomon Islands,SLB,2010,0,37009,0,0,0,0,37009
Solomon Islands,SLB,2012,0,0,0,0,0,0,0
Solomon Islands,SLB,2013,0,0,171712,0,0,0,171712
Solomon Islands,SLB,2014,0,786761,0,0,0,0,786761
Solomon Islands,SLB,1931,0,0,5351715,0,0,0,5351715
Solomon Islands,SLB,1975,0,0,10107902,0,0,0,10107902
Solomon Islands,SLB,1977,0,0,1611787,0,0,0,1611787
Solomon Islands,SLB,1988,0,0,32772,0,0,0,32772
Solomon Islands,SLB,2007,0,0,1030470,0,0,0,1030470
Solomon Islands,SLB,2016,0,0,0,0,0,0,0
Solomon Islands,SLB,1956,0,0,0,16625104,0,0,16625104
Solomon Islands,SLB,1966,0,0,0,192889,0,0,192889
Solomon Islands,SLB,1967,0,0,0,751494,0,0,751494
Solomon Islands,SLB,1968,0,0,0,60981,0,0,60981
Solomon Islands,SLB,1979,0,0,0,88574,0,0,88574
Solomon Islands,SLB,1982,0,0,0,0,0,0,0
Solomon Islands,SLB,1985,0,0,0,0,0,0,0
Solomon Islands,SLB,1986,0,0,0,3524887,0,0,3524887
Solomon Islands,SLB,1992,0,0,0,0,0,0,0
Solomon Islands,SLB,1993,0,0,0,112963,0,0,112963
Solomon Islands,SLB,2002,0,0,0,0,0,0,0
Solomon Islands,SLB,2003,0,0,0,0,0,0,0
Solomon Islands,SLB,2011,0,0,0,0,0,0,0
Solomon Islands,SLB,2018,0,0,0,0,0,0,0
Solomon Islands,SLB,2020,0,0,0,694446,0,0,694446
Solomon Islands,SLB,1971,0,0,0,0,0,0,0
Somalia,SOM,1964,157055,0,0,0,0,0,157055
Somalia,SOM,1969,0,0,0,0,0,0,0
Somalia,SOM,1973,47236185,0,0,0,0,0,47236185
Somalia,SOM,1980,0,0,0,0,0,0,0
Somalia,SOM,1983,0,0,0,0,0,0,0
Somalia,SOM,1987,838222,0,0,0,0,0,838222
Somalia,SOM,1988,0,0,0,0,0,0,0
Somalia,SOM,1999,25046,0,0,0,0,0,25046
Somalia,SOM,2004,0,0,294543,0,0,0,294543
Somalia,SOM,2005,1911,11464,0,0,0,0,13375
Somalia,SOM,2008,0,0,0,0,0,0,0
Somalia,SOM,2010,16629735,9146,0,0,0,0,16638881
Somalia,SOM,2011,0,0,0,0,0,0,0
Somalia,SOM,2014,0,0,0,0,0,0,0
Somalia,SOM,2015,0,0,0,0,0,0,0
Somalia,SOM,2019,0,10637,0,3754,0,0,14391
Somalia,SOM,2020,0,19351,0,5442,0,0,24793
Somalia,SOM,1961,0,678964,0,0,0,0,678964
Somalia,SOM,1977,0,0,0,0,0,0,0
Somalia,SOM,1981,0,8425,0,0,0,0,8425
Somalia,SOM,1989,0,48327,0,0,0,0,48327
Somalia,SOM,1994,0,143682,0,43104,0,0,186786
Somalia,SOM,1995,0,27736,0,0,0,0,27736
Somalia,SOM,1996,0,4015,0,0,0,0,4015
Somalia,SOM,1997,0,2987984,0,0,0,0,2987984
Somalia,SOM,2000,0,0,0,0,0,0,0
Somalia,SOM,2001,0,0,0,0,0,0,0
Somalia,SOM,2002,0,0,0,0,0,0,0
Somalia,SOM,2003,0,1025,0,0,0,0,1025
Somalia,SOM,2006,0,94576,0,0,0,0,94576
Somalia,SOM,2007,0,22486,0,0,0,0,22486
Somalia,SOM,2009,0,0,0,0,0,0,0
Somalia,SOM,2012,0,24919,0,0,0,0,24919
Somalia,SOM,2013,0,5446,0,126046,0,0,131492
Somalia,SOM,2016,0,6297,0,0,0,0,6297
Somalia,SOM,2018,0,3244,0,34391,0,0,37635
Somalia,SOM,2021,0,14649,0,0,0,0,14649
Somalia,SOM,2022,0,0,0,0,0,0,0
Somalia,SOM,2023,0,23700,0,0,0,0,23700
South Africa,ZAF,1964,0,0,0,0,0,0,0
South Africa,ZAF,1980,0,0,0,0,0,0,0
South Africa,ZAF,1981,0,34400,0,0,0,0,34400
South Africa,ZAF,1986,0,0,0,0,0,0,0
South Africa,ZAF,1988,0,6686,0,0,0,0,6686
South Africa,ZAF,1990,0,0,2508,502,0,0,3010
South Africa,ZAF,1995,0,47060,0,0,0,0,47060
South Africa,ZAF,2004,0,0,0,0,0,0,0
South Africa,ZAF,2015,0,0,0,0,0,0,0
South Africa,ZAF,2017,0,530,0,3531,0,1589,5650
South Africa,ZAF,2019,0,16871,0,689,0,0,17560
South Africa,ZAF,2021,0,5220,0,4546,0,0,9766
South Africa,ZAF,1959,0,31684,0,0,0,0,31684
South Africa,ZAF,1968,0,0,0,0,0,0,0
South Africa,ZAF,1974,0,10368,0,0,0,0,10368
South Africa,ZAF,1977,0,1471,0,0,0,0,1471
South Africa,ZAF,1978,0,9305,0,0,0,0,9305
South Africa,ZAF,1987,0,140091,0,0,0,0,140091
South Africa,ZAF,1993,0,2822,0,1646,0,0,4468
South Africa,ZAF,1994,0,0,0,462,0,0,462
South Africa,ZAF,1996,0,7613,0,0,6717,7613,21943
South Africa,ZAF,1997,0,0,3312,0,0,0,3312
South Africa,ZAF,1999,0,5823,0,5608,0,863,12294
South Africa,ZAF,2000,0,19866,0,214,0,0,20080
South Africa,ZAF,2001,0,1059,0,2964,0,6564,10587
South Africa,ZAF,2002,0,3357,0,4826,0,629,8812
South Africa,ZAF,2003,0,208,0,0,0,0,208
South Africa,ZAF,2006,0,2425,0,0,0,0,2425
South Africa,ZAF,2007,0,0,0,0,4400,5200,9600
South Africa,ZAF,2008,0,2175,0,989,0,6724,9888
South Africa,ZAF,2009,0,2736,0,3713,0,0,6449
South Africa,ZAF,2011,0,7627,0,1144,0,0,8771
South Africa,ZAF,2012,0,2446,0,0,0,0,2446
South Africa,ZAF,2014,0,5847,183,0,0,0,6030
South Africa,ZAF,2016,0,2304,0,0,1950,0,4254
South Africa,ZAF,2020,0,510,0,1701,0,0,2211
South Africa,ZAF,2022,0,96671,0,0,0,0,96671
South Africa,ZAF,2023,0,3310,0,828,0,0,4138
South Africa,ZAF,1969,0,0,4147,0,0,0,4147
South Africa,ZAF,2005,0,0,408,0,0,0,408
South Africa,ZAF,1952,0,0,0,25692,0,0,25692
South Africa,ZAF,1983,0,0,0,3138,0,0,3138
South Africa,ZAF,1984,0,0,0,19531,0,0,19531
South Africa,ZAF,1998,0,0,0,3926,0,5452,9378
South Africa,ZAF,2010,0,0,0,7724,0,0,7724
South Africa,ZAF,2013,0,0,0,557,0,0,557
South Africa,ZAF,1991,0,0,0,0,0,1222,1222
South Korea,KOR,1967,0,0,0,0,0,0,0
South Korea,KOR,2001,0,14873,0,2337,0,0,17210
South Korea,KOR,1957,0,105133,0,101302,0,0,206435
South Korea,KOR,1959,0,24764,0,172551,0,0,197315
South Korea,KOR,1961,0,93777,0,0,0,0,93777
South Korea,KOR,1962,0,106483,0,0,0,0,106483
South Korea,KOR,1965,0,110695,0,0,0,0,110695
South Korea,KOR,1966,0,31838,0,0,0,0,31838
South Korea,KOR,1969,0,127852,0,26636,0,0,154488
South Korea,KOR,1970,0,8589,0,11963,0,0,20552
South Korea,KOR,1972,0,219856,0,0,0,0,219856
South Korea,KOR,1977,0,85340,0,0,0,0,85340
South Korea,KOR,1978,0,7233,0,0,0,0,7233
South Korea,KOR,1984,0,40822,0,0,0,11558,52380
South Korea,KOR,1987,0,11791,0,145972,0,0,157763
South Korea,KOR,1990,0,28785,0,6120,9066,0,43971
South Korea,KOR,1991,0,12138,0,16184,0,0,28322
South Korea,KOR,1992,0,1118,0,0,0,0,1118
South Korea,KOR,1996,0,18616,0,0,0,4161,22777
South Korea,KOR,1997,0,3264,0,0,0,0,3264
South Korea,KOR,1998,0,87135,0,21622,0,0,108757
South Korea,KOR,1999,0,13757,0,860,0,0,14617
South Korea,KOR,2000,0,4275,0,7053,0,427,11755
South Korea,KOR,2002,0,4438,0,43110,0,0,47548
South Korea,KOR,2004,0,2095,0,2933,0,0,5028
South Korea,KOR,2005,0,3759,0,2297,0,0,6056
South Korea,KOR,2006,0,9573,0,0,0,0,9573
South Korea,KOR,2007,0,622,0,4148,0,0,4770
South Korea,KOR,2008,0,2066,0,0,0,0,2066
South Korea,KOR,2011,0,12609,0,0,0,11999,24608
South Korea,KOR,2014,0,3362,0,4747,0,0,8109
South Korea,KOR,2020,0,10030,0,5594,0,0,15624
South Korea,KOR,2022,0,2702,0,2316,386,0,5404
South Korea,KOR,2016,0,0,0,1754,1169,0,2923
South Korea,KOR,2017,0,0,0,0,0,0,0
South Korea,KOR,1936,0,0,0,762691,0,0,762691
South Korea,KOR,1964,0,0,0,73540,0,0,73540
South Korea,KOR,1968,0,0,0,5764,0,0,5764
South Korea,KOR,1971,0,0,0,32744,0,0,32744
South Korea,KOR,1979,0,0,0,30473,0,0,30473
South Korea,KOR,1980,0,0,0,43227,0,0,43227
South Korea,KOR,1981,0,0,0,29175,0,0,29175
South Korea,KOR,1982,0,0,0,17257,0,0,17257
South Korea,KOR,1985,0,0,0,13824,0,0,13824
South Korea,KOR,1986,0,0,0,7893,0,0,7893
South Korea,KOR,1989,0,0,0,25019,0,0,25019
South Korea,KOR,1993,0,0,0,7122,0,2448,9570
South Korea,KOR,1994,0,0,0,6199,0,0,6199
South Korea,KOR,1995,0,0,0,16082,0,0,16082
South Korea,KOR,2003,0,0,0,27346,0,0,27346
South Korea,KOR,2010,0,0,0,2458,0,0,2458
South Korea,KOR,2012,0,0,0,4432,0,0,4432
South Korea,KOR,2019,0,0,0,3861,0,193,4054
South Korea,KOR,2021,0,0,0,0,0,0,0
South Korea,KOR,2023,0,0,0,386,0,193,579
South Korea,KOR,2018,0,0,0,0,0,0,0
South Korea,KOR,1956,0,0,0,0,0,45248,45248
South Korea,KOR,1963,0,0,0,0,0,41568,41568
South Korea,KOR,1976,0,0,0,0,0,6858,6858
South Korea,KOR,1988,0,0,0,0,0,5816,5816
Spain,ESP,1980,0,0,0,0,0,0,0
Spain,ESP,1981,0,0,0,0,0,0,0
Spain,ESP,1990,0,0,0,2314,0,0,2314
Spain,ESP,1999,0,0,0,1480,0,0,1480
Spain,ESP,2023,0,0,0,0,0,0,0
Spain,ESP,1953,0,17462,0,0,0,0,17462
Spain,ESP,1957,0,26033,0,8790,0,0,34823
Spain,ESP,1962,0,143305,0,0,0,0,143305
Spain,ESP,1972,0,0,0,0,0,0,0
Spain,ESP,1973,0,143274,0,5444,0,0,148718
Spain,ESP,1978,0,543,0,0,0,0,543
Spain,ESP,1979,0,5378,0,0,0,0,5378
Spain,ESP,1982,0,20273,0,0,0,0,20273
Spain,ESP,1983,0,11789,0,0,0,0,11789
Spain,ESP,1987,0,1292,0,0,0,0,1292
Spain,ESP,1989,0,3089,0,8495,0,0,11584
Spain,ESP,1994,0,2524,0,3028,0,5047,10599
Spain,ESP,1996,0,250,0,0,0,21002,21252
Spain,ESP,1997,0,1244,0,5226,0,0,6470
Spain,ESP,2000,0,5891,0,3436,0,0,9327
Spain,ESP,2001,0,1709,0,2441,0,0,4150
Spain,ESP,2002,0,5304,0,0,0,0,5304
Spain,ESP,2004,0,0,0,0,9078,698,9776
Spain,ESP,2006,0,0,0,0,4727,900,5627
Spain,ESP,2007,0,1105,0,221,0,0,1326
Spain,ESP,2010,0,429,0,644,0,0,1073
Spain,ESP,2011,0,214,2140,0,0,0,2354
Spain,ESP,2012,0,2139,0,0,0,856,2995
Spain,ESP,2013,0,0,0,0,0,0,0
Spain,ESP,2015,0,1723,0,0,0,0,1723
Spain,ESP,2016,0,1076,0,0,0,0,1076
Spain,ESP,2018,0,2778,0,427,1923,0,5128
Spain,ESP,2019,0,3607,0,1697,424,0,5728
Spain,ESP,2021,0,632,0,1053,0,211,1896
Spain,ESP,1956,0,0,3750,0,0,0,3750
Spain,ESP,1941,0,0,0,7699,0,0,7699
Spain,ESP,1971,0,0,0,0,117187,0,117187
Spain,ESP,1984,0,0,0,2348,0,4435,6783
Spain,ESP,1998,0,0,0,0,0,0,0
Spain,ESP,2005,0,0,0,4349,2060,2518,8927
Spain,ESP,2009,0,0,0,3019,0,1294,4313
Spain,ESP,2014,0,0,0,646,0,0,646
Spain,ESP,2020,0,0,0,3589,0,0,3589
Spain,ESP,1985,0,0,0,0,10397,0,10397
Spain,ESP,1995,0,0,0,0,7535,0,7535
Spain,ESP,2003,0,0,0,0,3573267,1184,3574451
Spain,ESP,2022,0,0,0,0,2381061,0,2381061
Spain,ESP,1991,0,0,0,0,0,0,0
Spain,ESP,2017,0,0,0,0,0,859,859
Sri Lanka,LKA,1977,0,0,0,0,0,19069,19069
Sri Lanka,LKA,1979,0,0,0,0,0,0,0
Sri Lanka,LKA,1980,0,0,0,0,0,0,0
Sri Lanka,LKA,1981,0,4606,0,0,0,0,4606
Sri Lanka,LKA,1982,0,34977,0,0,0,0,34977
Sri Lanka,LKA,1987,0,0,0,0,0,0,0
Sri Lanka,LKA,1988,0,0,0,0,0,0,0
Sri Lanka,LKA,2001,0,0,0,0,0,0,0
Sri Lanka,LKA,2012,0,25218,0,0,0,0,25218
Sri Lanka,LKA,2014,0,44728,0,0,0,113468,158196
Sri Lanka,LKA,2016,0,94747,0,0,0,0,94747
Sri Lanka,LKA,2019,0,13857,0,0,0,0,13857
Sri Lanka,LKA,1966,0,20354,0,0,0,0,20354
Sri Lanka,LKA,1967,0,20741,0,0,0,0,20741
Sri Lanka,LKA,1969,0,51158,0,0,0,0,51158
Sri Lanka,LKA,1978,0,6937,0,513361,0,0,520298
Sri Lanka,LKA,1983,0,1916,0,0,0,0,1916
Sri Lanka,LKA,1984,0,32131,0,0,0,0,32131
Sri Lanka,LKA,1986,0,26351,0,0,0,0,26351
Sri Lanka,LKA,1989,0,191282,0,0,0,0,191282
Sri Lanka,LKA,1990,0,19181,0,0,0,0,19181
Sri Lanka,LKA,1991,0,15502,0,0,0,0,15502
Sri Lanka,LKA,1992,0,8511,0,0,0,0,8511
Sri Lanka,LKA,1993,0,4488,0,0,0,36464,40952
Sri Lanka,LKA,1994,0,0,0,0,0,0,0
Sri Lanka,LKA,1995,0,1650,0,0,0,0,1650
Sri Lanka,LKA,1996,0,0,0,0,0,0,0
Sri Lanka,LKA,1997,0,5420,0,0,0,0,5420
Sri Lanka,LKA,1998,0,1616,0,0,0,0,1616
Sri Lanka,LKA,1999,0,3214,0,0,0,0,3214
Sri Lanka,LKA,2000,0,2663,0,2663,0,0,5326
Sri Lanka,LKA,2002,0,1047,0,0,0,0,1047
Sri Lanka,LKA,2003,0,121742,0,0,0,0,121742
Sri Lanka,LKA,2004,0,3078,18162244,0,0,0,18165322
Sri Lanka,LKA,2005,0,3050,0,0,0,0,3050
Sri Lanka,LKA,2006,0,12581,0,0,0,0,12581
Sri Lanka,LKA,2007,0,16435,0,0,0,0,16435
Sri Lanka,LKA,2008,0,23662,0,4437,0,0,28099
Sri Lanka,LKA,2009,0,1465,0,0,0,0,1465
Sri Lanka,LKA,2010,0,16934,0,0,0,0,16934
Sri Lanka,LKA,2011,0,31160,0,10547,0,0,41707
Sri Lanka,LKA,2013,0,52054,0,3313,0,0,55367
Sri Lanka,LKA,2015,0,4687,0,0,0,0,4687
Sri Lanka,LKA,2017,0,140421,0,12554,0,0,152975
Sri Lanka,LKA,2018,0,15755,0,0,0,0,15755
Sri Lanka,LKA,2020,0,2763,0,1842,0,0,4605
Sri Lanka,LKA,2021,0,16075,0,0,0,0,16075
Sri Lanka,LKA,2022,0,5496,0,1374,0,0,6870
Sri Lanka,LKA,1957,0,0,0,219227,0,0,219227
Sri Lanka,LKA,1964,0,0,0,191199,0,0,191199
Sri Lanka,LKA,1985,0,0,0,0,0,0,0
Sri Lanka,LKA,2023,0,0,0,0,0,0,0
Sri Lanka,LKA,1974,0,0,0,0,0,20122,20122
South Sudan,SSD,2009,0,0,0,0,0,0,0
South Sudan,SSD,2016,0,0,0,0,0,0,0
South Sudan,SSD,2021,0,6513,0,0,0,0,6513
South Sudan,SSD,2008,0,19266,0,0,0,0,19266
South Sudan,SSD,2010,0,0,0,0,0,0,0
South Sudan,SSD,2012,0,43919,0,0,0,0,43919
South Sudan,SSD,2013,0,89141,0,0,0,0,89141
South Sudan,SSD,2019,0,2871,0,0,0,47858,50729
South Sudan,SSD,2020,0,0,0,0,0,0,0
South Sudan,SSD,2022,0,0,0,0,0,0,0
Sudan,SDN,1980,0,0,0,0,0,0,0
Sudan,SDN,1983,80068320,0,0,0,0,0,80068320
Sudan,SDN,1987,0,0,0,0,0,0,0
Sudan,SDN,1990,0,0,0,0,0,0,0
Sudan,SDN,1991,0,0,0,0,0,0,0
Sudan,SDN,1996,0,63699,0,0,0,0,63699
Sudan,SDN,1999,0,14824,0,0,0,0,14824
Sudan,SDN,2011,0,0,0,5811,0,0,5811
Sudan,SDN,2015,0,5240,0,0,4192,0,9432
Sudan,SDN,2022,0,31147,0,0,0,0,31147
Sudan,SDN,1975,0,0,0,0,0,0,0
Sudan,SDN,1978,0,22214,0,0,0,0,22214
Sudan,SDN,1988,0,46935,0,0,0,0,46935
Sudan,SDN,1993,0,9475,1354,0,0,0,10829
Sudan,SDN,1994,0,3524,0,0,0,0,3524
Sudan,SDN,1997,0,3271,0,0,0,0,3271
Sudan,SDN,1998,0,41152,0,0,0,18778,59930
Sudan,SDN,2001,0,1113,0,0,0,0,1113
Sudan,SDN,2002,0,0,0,11969,0,0,11969
Sudan,SDN,2003,0,7095,0,0,0,0,7095
Sudan,SDN,2005,0,1693,0,0,0,0,1693
Sudan,SDN,2006,0,8901,0,0,0,0,8901
Sudan,SDN,2007,0,48091,0,0,0,0,48091
Sudan,SDN,2009,0,6070,0,0,0,0,6070
Sudan,SDN,2010,0,10670,0,0,0,0,10670
Sudan,SDN,2012,0,9955,0,0,0,0,9955
Sudan,SDN,2013,0,21117,0,0,0,0,21117
Sudan,SDN,2014,0,10540,0,0,0,0,10540
Sudan,SDN,2016,0,43426,0,0,0,0,43426
Sudan,SDN,2017,0,6146,0,0,0,0,6146
Sudan,SDN,2018,0,10953,0,0,0,0,10953
Sudan,SDN,2019,0,18042,0,0,0,0,18042
Sudan,SDN,2020,0,34878,0,0,0,0,34878
Sudan,SDN,2021,0,11389,0,0,0,0,11389
Suriname,SUR,1969,0,0,0,0,0,0,0
Suriname,SUR,2006,0,57467,0,0,0,0,57467
Suriname,SUR,2008,0,37457,0,0,0,0,37457
Suriname,SUR,2021,0,0,0,0,0,0,0
Suriname,SUR,2022,0,0,0,0,0,0,0
Swaziland,SWZ,1981,8114078,0,0,0,0,0,8114078
Swaziland,SWZ,1984,0,0,0,782504,0,0,782504
Swaziland,SWZ,1990,0,0,0,0,0,0,0
Swaziland,SWZ,2001,0,0,0,0,0,0,0
Swaziland,SWZ,2007,0,0,0,0,0,18450,18450
Swaziland,SWZ,2016,0,0,0,0,0,0,0
Swaziland,SWZ,2019,0,0,0,0,0,0,0
Swaziland,SWZ,2000,0,0,0,0,0,0,0
Swaziland,SWZ,2008,0,0,0,0,0,0,0
Swaziland,SWZ,2014,0,97702,0,0,0,0,97702
Swaziland,SWZ,2005,0,0,0,0,0,0,0
Swaziland,SWZ,2006,0,0,0,9279,0,0,9279
Swaziland,SWZ,2021,0,0,0,0,0,0,0
Swaziland,SWZ,2022,0,0,0,0,0,0,0
Sweden,SWE,1977,0,0,0,0,0,15729,15729
Sweden,SWE,1985,0,13111,0,0,0,0,13111
Sweden,SWE,2021,0,0,0,0,0,0,0
Sweden,SWE,1976,0,0,0,0,0,0,0
Sweden,SWE,1990,0,0,0,0,0,0,0
Sweden,SWE,1999,0,0,0,3390,0,0,3390
Sweden,SWE,2002,0,0,0,1120,0,0,1120
Sweden,SWE,2005,0,0,0,7733,0,0,7733
Sweden,SWE,2013,0,0,0,7255,0,0,7255
Sweden,SWE,2020,0,0,0,964,0,0,964
Sweden,SWE,2022,0,0,0,0,37917,0,37917
Sweden,SWE,2018,0,0,0,0,0,0,0
Switzerland,CHE,1977,0,0,0,0,0,0,0
Switzerland,CHE,1983,0,0,0,0,0,0,0
Switzerland,CHE,1987,0,0,0,1528,0,0,1528
Switzerland,CHE,1997,0,0,0,0,0,0,0
Switzerland,CHE,1999,0,4200,0,16802,0,42004,63006
Switzerland,CHE,2005,0,8077,0,0,0,0,8077
Switzerland,CHE,2006,0,0,0,1338,0,0,1338
Switzerland,CHE,2007,0,1326,0,0,0,0,1326
Switzerland,CHE,2021,0,0,0,0,0,19560,19560
Switzerland,CHE,1976,0,0,0,0,0,0,0
Switzerland,CHE,1982,0,0,0,0,0,0,0
Switzerland,CHE,1984,0,0,0,0,0,0,0
Switzerland,CHE,1985,0,0,0,0,0,0,0
Switzerland,CHE,1986,0,0,0,0,0,0,0
Switzerland,CHE,1990,0,0,0,7450,0,0,7450
Switzerland,CHE,1993,0,0,0,2883,0,0,2883
Switzerland,CHE,1994,0,0,0,0,0,0,0
Switzerland,CHE,1998,0,0,0,0,0,0,0
Switzerland,CHE,2002,0,0,0,1374,0,5497,6871
Switzerland,CHE,2003,0,0,0,0,1417322,0,1417322
Switzerland,CHE,2009,0,0,0,0,0,0,0
Switzerland,CHE,2010,0,0,0,0,0,0,0
Switzerland,CHE,2011,0,0,0,0,0,0,0
Switzerland,CHE,2013,0,0,0,0,0,0,0
Switzerland,CHE,2014,0,0,0,2443,0,0,2443
Switzerland,CHE,2018,0,0,0,0,0,0,0
Switzerland,CHE,2019,0,0,0,4664,0,0,4664
Switzerland,CHE,2020,0,0,0,0,0,0,0
Switzerland,CHE,2023,0,0,0,2274,0,2274,4548
Switzerland,CHE,2001,0,0,0,0,0,0,0
Switzerland,CHE,2012,0,0,0,0,13757,0,13757
Switzerland,CHE,2022,0,0,0,0,345519,0,345519
Switzerland,CHE,1951,0,0,0,0,0,193762,193762
Switzerland,CHE,1965,0,0,0,0,0,153661,153661
Switzerland,CHE,1968,0,0,0,0,0,32959,32959
Switzerland,CHE,1970,0,0,0,0,0,48534,48534
Switzerland,CHE,1975,0,0,0,0,0,20510,20510
Switzerland,CHE,1988,0,0,0,0,0,0,0
Switzerland,CHE,2000,0,0,0,0,0,22278,22278
Switzerland,CHE,2017,0,0,0,0,0,9466,9466
Syria,SYR,1999,0,0,0,0,0,0,0
Syria,SYR,2008,0,0,0,0,0,0,0
Syria,SYR,2021,0,469,0,0,0,0,469
Syria,SYR,1967,0,0,0,0,0,0,0
Syria,SYR,1974,0,0,0,0,0,0,0
Syria,SYR,2006,0,3088,0,0,0,0,3088
Syria,SYR,2019,0,995,0,0,0,0,995
Syria,SYR,2023,0,0,1937400,0,0,0,1937400
Syria,SYR,2001,0,0,0,16141,0,0,16141
Syria,SYR,2004,0,0,0,2765,0,0,2765
Syria,SYR,2015,0,0,0,6769,0,0,6769
Syria,SYR,2022,0,0,0,904,0,0,904
Syria,SYR,2002,0,0,0,0,0,46609,46609
Syria,SYR,2020,0,0,0,0,0,1444,1444
Taiwan,TWN,1977,0,26206,0,35524,0,0,61730
Taiwan,TWN,1984,0,16105,0,0,0,0,16105
Taiwan,TWN,1997,0,4595,0,20216,0,0,24811
Taiwan,TWN,1998,0,1369,0,5932,0,0,7301
Taiwan,TWN,2005,0,7019,0,7457,0,0,14476
Taiwan,TWN,2006,0,1311,874,1311,0,0,3496
Taiwan,TWN,2012,0,2582,0,6026,0,0,8608
Taiwan,TWN,2017,0,2113,0,423,0,0,2536
Taiwan,TWN,1904,0,0,498892,0,0,0,498892
Taiwan,TWN,1906,0,0,4179533,0,0,0,4179533
Taiwan,TWN,1909,0,0,28289,0,0,0,28289
Taiwan,TWN,1910,0,0,185873,0,0,0,185873
Taiwan,TWN,1916,0,0,518320,0,0,0,518320
Taiwan,TWN,1917,0,0,153335,0,0,0,153335
Taiwan,TWN,1922,0,0,13286,0,0,0,13286
Taiwan,TWN,1930,0,0,8908,0,0,0,8908
Taiwan,TWN,1935,0,0,11780072,0,0,0,11780072
Taiwan,TWN,1936,0,0,19075,0,0,0,19075
Taiwan,TWN,1941,0,0,532149,0,0,0,532149
Taiwan,TWN,1946,0,0,92092,0,0,0,92092
Taiwan,TWN,1951,0,0,107125,126029,0,0,233154
Taiwan,TWN,1959,0,0,15076,985605,0,0,1000681
Taiwan,TWN,1963,0,0,12295,0,0,0,12295
Taiwan,TWN,1964,0,0,84713,0,0,0,84713
Taiwan,TWN,1986,0,0,6578,32892,0,7084,46554
Taiwan,TWN,1999,0,0,1026875,0,0,0,1026875
Taiwan,TWN,2002,0,0,1780,3560,0,0,5340
Taiwan,TWN,2010,0,0,0,14729,0,0,14729
Taiwan,TWN,2013,0,0,2143,2143,0,0,4286
Taiwan,TWN,2016,0,0,49588,4238,36025,0,89851
Taiwan,TWN,2018,0,0,35404,2950,0,0,38354
Taiwan,TWN,2022,0,0,419,0,0,0,419
Taiwan,TWN,1911,0,0,0,3073176,0,0,3073176
Taiwan,TWN,1924,0,0,0,2560858,0,0,2560858
Taiwan,TWN,1953,0,0,0,78160,0,0,78160
Taiwan,TWN,1958,0,0,0,30223,0,0,30223
Taiwan,TWN,1960,0,0,0,181187,0,0,181187
Taiwan,TWN,1961,0,0,0,93213,0,0,93213
Taiwan,TWN,1962,0,0,0,90839,0,0,90839
Taiwan,TWN,1965,0,0,0,42079,0,0,42079
Taiwan,TWN,1966,0,0,0,26635,0,0,26635
Taiwan,TWN,1967,0,0,0,49577,0,0,49577
Taiwan,TWN,1969,0,0,0,184029,0,0,184029
Taiwan,TWN,1981,0,0,0,14130,0,0,14130
Taiwan,TWN,1983,0,0,0,43212,0,0,43212
Taiwan,TWN,1987,0,0,0,30506,0,0,30506
Taiwan,TWN,1989,0,0,0,6371,0,0,6371
Taiwan,TWN,1990,0,0,0,2429,0,0,2429
Taiwan,TWN,1991,0,0,0,15888,0,0,15888
Taiwan,TWN,1992,0,0,0,3818,0,0,3818
Taiwan,TWN,1994,0,0,0,21133,0,0,21133
Taiwan,TWN,1996,0,0,0,30075,0,0,30075
Taiwan,TWN,2000,0,0,0,46407,0,0,46407
Taiwan,TWN,2001,0,0,0,87314,0,0,87314
Taiwan,TWN,2003,0,0,0,1328,0,0,1328
Taiwan,TWN,2004,0,0,0,34797,0,0,34797
Taiwan,TWN,2007,0,0,0,7846,0,0,7846
Taiwan,TWN,2008,0,0,0,23480,0,0,23480
Taiwan,TWN,2009,0,0,0,273389,0,0,273389
Taiwan,TWN,2014,0,0,0,0,0,0,0
Taiwan,TWN,2015,0,0,0,3828,0,0,3828
Taiwan,TWN,2019,0,0,0,841,0,0,841
Taiwan,TWN,2020,0,0,0,420,0,0,420
Taiwan,TWN,2021,0,0,0,7544,0,0,7544
Taiwan,TWN,2023,0,0,0,418,0,0,418
Tajikistan,TJK,2000,0,0,0,0,0,0,0
Tajikistan,TJK,2008,0,0,0,0,0,0,0
Tajikistan,TJK,1992,0,2379683,0,0,0,450831,2830514
Tajikistan,TJK,1994,0,0,0,0,0,0,0
Tajikistan,TJK,1996,0,0,0,0,0,0,0
Tajikistan,TJK,1998,0,82835,0,0,0,17866,100701
Tajikistan,TJK,1999,0,43622,0,0,0,0,43622
Tajikistan,TJK,2001,0,0,0,0,0,1560,1560
Tajikistan,TJK,2002,0,48917,4586,0,0,0,53503
Tajikistan,TJK,2003,0,8992,0,0,0,1499,10491
Tajikistan,TJK,2004,0,0,0,0,0,0,0
Tajikistan,TJK,2005,0,11545,0,0,0,23091,34636
Tajikistan,TJK,2007,0,30605,15302,0,0,22258,68165
Tajikistan,TJK,2009,0,28118,0,0,0,0,28118
Tajikistan,TJK,2010,0,98402,0,0,0,0,98402
Tajikistan,TJK,2011,0,0,0,0,0,0,0
Tajikistan,TJK,2012,0,0,2514,0,1257,0,3771
Tajikistan,TJK,2014,0,24020,0,0,0,0,24020
Tajikistan,TJK,2015,0,0,2346,0,0,11731,14077
Tajikistan,TJK,2016,0,4584,0,0,0,0,4584
Tajikistan,TJK,2017,0,0,0,0,0,14565,14565
Tajikistan,TJK,2018,0,6573,0,0,0,0,6573
Tajikistan,TJK,2019,0,4284,0,0,0,0,4284
Tajikistan,TJK,2020,0,2096,0,0,0,0,2096
Tajikistan,TJK,2021,0,7179,5128,0,0,12308,24615
Tajikistan,TJK,2023,0,20703,0,0,0,0,20703
Tajikistan,TJK,2006,0,0,4251,0,0,31173,35424
Tajikistan,TJK,2013,0,0,0,0,0,0,0
Tajikistan,TJK,1993,0,0,0,0,0,8745,8745
Tajikistan,TJK,1997,0,0,0,0,0,65391,65391
Tanzania,TZA,1967,0,0,0,0,0,0,0
Tanzania,TZA,1977,0,0,0,0,0,0,0
Tanzania,TZA,1984,0,0,0,0,0,0,0
Tanzania,TZA,1988,0,0,0,0,0,0,0
Tanzania,TZA,1990,0,72121,0,0,0,0,72121
Tanzania,TZA,1996,0,0,0,0,0,0,0
Tanzania,TZA,2003,0,0,0,0,0,0,0
Tanzania,TZA,2004,0,0,2607,0,0,0,2607
Tanzania,TZA,2006,0,0,0,0,0,0,0
Tanzania,TZA,2011,0,7971,0,0,0,0,7971
Tanzania,TZA,2021,0,157,0,0,0,0,157
Tanzania,TZA,1964,0,0,3543,0,0,0,3543
Tanzania,TZA,1968,0,31397,0,0,0,0,31397
Tanzania,TZA,1974,0,15953,0,0,0,0,15953
Tanzania,TZA,1978,0,0,0,0,0,0,0
Tanzania,TZA,1979,0,0,0,0,0,0,0
Tanzania,TZA,1982,0,0,0,0,0,0,0
Tanzania,TZA,1986,0,0,0,0,0,0,0
Tanzania,TZA,1989,0,3918,0,0,0,0,3918
Tanzania,TZA,1993,0,18968,0,0,0,0,18968
Tanzania,TZA,1994,0,10474,0,1351,0,0,11825
Tanzania,TZA,1995,0,982,0,0,0,0,982
Tanzania,TZA,1997,0,26112,0,0,0,0,26112
Tanzania,TZA,1998,0,18696,0,0,0,0,18696
Tanzania,TZA,2000,0,10446,290,0,0,0,10736
Tanzania,TZA,2001,0,1412,0,0,0,3671,5083
Tanzania,TZA,2002,0,2476,550,0,0,0,3026
Tanzania,TZA,2005,0,254,507,0,0,0,761
Tanzania,TZA,2008,0,17028,0,0,0,0,17028
Tanzania,TZA,2009,0,8645,0,0,0,0,8645
Tanzania,TZA,2012,0,2093,0,0,0,0,2093
Tanzania,TZA,2014,0,6101,0,0,0,0,6101
Tanzania,TZA,2015,0,2284,0,8945,0,0,11229
Tanzania,TZA,2016,0,2941,3125,0,0,0,6066
Tanzania,TZA,2017,0,1244,0,0,0,0,1244
Tanzania,TZA,2018,0,2582,0,0,0,0,2582
Tanzania,TZA,2019,0,7850,0,0,0,0,7850
Tanzania,TZA,2020,0,6969,0,0,0,0,6969
Tanzania,TZA,2022,0,1527,0,0,0,0,1527
Tanzania,TZA,2023,0,1928,0,0,0,0,1928
Thailand,THA,1991,0,3030,0,6774,0,0,9804
Thailand,THA,1993,0,7096,0,692,0,0,7788
Thailand,THA,1999,0,3523,0,0,0,0,3523
Thailand,THA,2002,0,23979,0,156,0,5450,29585
Thailand,THA,2005,0,11546,0,1519,0,0,13065
Thailand,THA,2008,0,5793,0,0,0,0,5793
Thailand,THA,2010,0,37791,0,0,0,0,37791
Thailand,THA,2011,0,127633,146,2620,0,0,130399
Thailand,THA,2012,0,0,0,0,0,0,0
Thailand,THA,2014,0,4145,143,0,9005,0,13293
Thailand,THA,2015,0,0,0,427,0,0,427
Thailand,THA,2019,0,2665,0,982,0,0,3647
Thailand,THA,1966,0,1882,0,0,0,0,1882
Thailand,THA,1975,0,58423,0,0,0,0,58423
Thailand,THA,1978,0,21914,0,11414,0,0,33328
Thailand,THA,1980,0,12462,0,0,0,0,12462
Thailand,THA,1983,0,10273,0,0,0,0,10273
Thailand,THA,1984,0,3425,0,0,0,0,3425
Thailand,THA,1985,0,3558,0,0,0,0,3558
Thailand,THA,1986,0,8149,0,0,0,0,8149
Thailand,THA,1987,0,4573,0,0,0,0,4573
Thailand,THA,1988,0,124319,0,0,0,0,124319
Thailand,THA,1994,0,17403,0,3242,0,1536,22181
Thailand,THA,1995,0,38873,0,4544,0,0,43417
Thailand,THA,1996,0,15113,0,1495,0,0,16608
Thailand,THA,1997,0,2295,0,32465,0,0,34760
Thailand,THA,2000,0,16966,0,317,0,0,17283
Thailand,THA,2001,0,29694,0,0,0,0,29694
Thailand,THA,2003,0,1389,0,0,0,0,1389
Thailand,THA,2004,0,1990,1277730,2144,0,459,1282323
Thailand,THA,2006,0,42220,0,0,0,0,42220
Thailand,THA,2007,0,7931,0,0,0,0,7931
Thailand,THA,2009,0,2212,0,0,0,0,2212
Thailand,THA,2013,0,12073,0,0,0,0,12073
Thailand,THA,2016,0,2974,0,0,1983,0,4957
Thailand,THA,2017,0,21157,0,0,0,0,21157
Thailand,THA,2020,0,4337,0,1819,0,0,6156
Thailand,THA,2021,0,1955,0,279,0,0,2234
Thailand,THA,2022,0,2650,0,279,0,0,2929
Thailand,THA,2023,0,0,0,0,0,0,0
Thailand,THA,1962,0,0,0,272288,0,0,272288
Thailand,THA,1981,0,0,0,11770,0,0,11770
Thailand,THA,1989,0,0,0,84309,0,0,84309
Thailand,THA,1990,0,0,0,6518,0,0,6518
Thailand,THA,1992,0,0,0,1054,0,0,1054
Timor-Leste,TLS,2007,0,9810,0,0,0,0,9810
Timor-Leste,TLS,2016,0,0,0,0,0,0,0
Timor-Leste,TLS,2001,0,11198,0,0,0,0,11198
Timor-Leste,TLS,2003,0,32372,0,0,0,0,32372
Timor-Leste,TLS,2020,0,23077,0,0,0,0,23077
Timor-Leste,TLS,2015,0,0,0,0,0,0,0
Timor-Leste,TLS,2006,0,0,0,0,0,0,0
Timor-Leste,TLS,2021,0,0,0,310384,0,0,310384
Togo,TGO,1971,0,0,0,0,0,0,0
Togo,TGO,1980,0,0,0,0,0,0,0
Togo,TGO,1989,0,0,0,0,0,0,0
Togo,TGO,1994,0,0,0,0,0,0,0
Togo,TGO,1995,0,7010,0,0,0,0,7010
Togo,TGO,1998,0,0,0,0,0,0,0
Togo,TGO,1999,0,0,0,0,0,0,0
Togo,TGO,2006,0,0,0,0,0,0,0
Togo,TGO,2007,0,67796,0,0,0,0,67796
Togo,TGO,2008,0,9642,0,0,0,0,9642
Togo,TGO,2009,0,0,0,0,0,0,0
Togo,TGO,2010,0,33476,0,0,0,0,33476
Togo,TGO,2017,0,0,0,0,0,0,0
Togo,TGO,2020,0,13029,0,0,0,0,13029
Togo,TGO,2022,0,0,0,0,0,0,0
Togo,TGO,1966,0,0,0,0,0,0,0
Tokelau,TKL,1966,0,0,0,0,0,0,0
Tokelau,TKL,1987,0,0,0,0,0,0,0
Tokelau,TKL,1990,0,0,0,0,0,0,0
Tokelau,TKL,2005,0,0,0,0,0,0,0
Tonga,TON,2015,0,0,0,0,0,0,0
Tonga,TON,1977,0,0,104310,0,0,0,104310
Tonga,TON,2009,0,0,839874,0,0,0,839874
Tonga,TON,1961,0,0,0,288164,0,0,288164
Tonga,TON,1973,0,0,0,331027,0,0,331027
Tonga,TON,1982,0,0,0,722014,0,0,722014
Tonga,TON,1990,0,0,0,101272,0,0,101272
Tonga,TON,1997,0,0,0,0,0,0,0
Tonga,TON,1998,0,0,0,0,0,0,0
Tonga,TON,2001,0,0,0,0,0,0,0
Tonga,TON,2004,0,0,0,0,0,0,0
Tonga,TON,2011,0,0,0,0,0,0,0
Tonga,TON,2014,0,0,0,93774,0,0,93774
Tonga,TON,2016,0,0,0,0,0,0,0
Tonga,TON,2018,0,0,0,0,0,0,0
Tonga,TON,2020,0,0,0,0,0,0,0
Tonga,TON,1946,0,0,0,0,0,0,0
Tonga,TON,2022,0,0,0,0,0,374297,374297
Trinidad and Tobago,TTO,2010,0,0,0,0,0,0,0
Trinidad and Tobago,TTO,1993,0,38641,0,0,0,0,38641
Trinidad and Tobago,TTO,1996,0,0,0,0,0,0,0
Trinidad and Tobago,TTO,2018,0,0,0,0,0,0,0
Trinidad and Tobago,TTO,2022,0,0,0,0,0,0,0
Trinidad and Tobago,TTO,1997,0,0,0,0,0,0,0
Trinidad and Tobago,TTO,1933,0,0,0,298177,0,0,298177
Trinidad and Tobago,TTO,1963,0,0,0,267360,0,0,267360
Trinidad and Tobago,TTO,1974,0,0,0,19225,0,0,19225
Trinidad and Tobago,TTO,1990,0,0,0,0,0,0,0
Trinidad and Tobago,TTO,2004,0,0,0,7347,0,14693,22040
Trinidad and Tobago,TTO,2005,0,0,0,0,0,0,0
Tunisia,TUN,1977,0,0,0,0,0,0,0
Tunisia,TUN,1988,0,0,0,0,0,0,0
Tunisia,TUN,1962,0,93420,0,0,0,0,93420
Tunisia,TUN,1964,0,111632,0,0,0,0,111632
Tunisia,TUN,1969,0,1098640,0,0,0,0,1098640
Tunisia,TUN,1973,0,203161,0,0,0,0,203161
Tunisia,TUN,1979,0,0,0,0,0,0,0
Tunisia,TUN,1982,0,169198,0,0,0,0,169198
Tunisia,TUN,1986,0,29965,0,0,0,0,29965
Tunisia,TUN,1990,0,43839,0,0,0,0,43839
Tunisia,TUN,2003,0,11772,0,0,0,0,11772
Tunisia,TUN,2007,0,15122,0,0,0,0,15122
Tunisia,TUN,2009,0,15763,0,0,0,0,15763
Tunisia,TUN,2018,0,10894,0,0,0,0,10894
Tunisia,TUN,2020,0,4934,0,0,0,0,4934
Tunisia,TUN,2021,0,2446,0,0,0,0,2446
Tunisia,TUN,2022,0,809,0,0,0,0,809
Tunisia,TUN,1957,0,0,31772,0,0,0,31772
Tunisia,TUN,2017,0,0,0,0,0,0,0
Turkey,TUR,1948,0,164956,0,0,0,0,164956
Turkey,TUR,1956,0,56387,0,0,0,0,56387
Turkey,TUR,1957,0,39225,20999,0,0,0,60224
Turkey,TUR,1964,0,0,7513,0,0,0,7513
Turkey,TUR,1968,0,43383,7083,0,0,0,50466
Turkey,TUR,1974,0,8491,0,0,0,0,8491
Turkey,TUR,1980,0,17011,0,0,0,9073,26084
Turkey,TUR,1981,0,2223,0,0,0,0,2223
Turkey,TUR,1984,0,0,1247,0,0,0,1247
Turkey,TUR,1988,0,2487,0,0,0,12243,14730
Turkey,TUR,1990,0,12702,0,0,0,0,12702
Turkey,TUR,1991,0,7592,0,181,0,0,7773
Turkey,TUR,1995,0,10623,15850,0,0,12478,38951
Turkey,TUR,1998,0,14781,23617,0,0,0,38398
Turkey,TUR,2000,0,312,468,0,1716,0,2496
Turkey,TUR,2001,0,1844,0,0,4457,1383,7684
Turkey,TUR,2002,0,5152,6365,1515,0,0,13032
Turkey,TUR,2003,0,1196,26620,0,0,0,27816
Turkey,TUR,2004,0,3393,3983,3688,1475,0,12539
Turkey,TUR,2005,0,1019,291,291,2474,2183,6258
Turkey,TUR,2006,0,8477,0,0,0,0,8477
Turkey,TUR,2007,0,2271,0,0,426,0,2697
Turkey,TUR,2009,0,6507,0,0,0,2077,8584
Turkey,TUR,2011,0,1079,87228,0,0,0,88307
Turkey,TUR,2012,0,1727,0,0,0,0,1727
Turkey,TUR,2015,0,2134,0,0,0,0,2134
Turkey,TUR,2019,0,2156,120,0,0,0,2276
Turkey,TUR,2020,0,2853,19730,238,0,4873,27694
Turkey,TUR,2021,0,8611,0,0,0,1062,9673
Turkey,TUR,2022,0,352,234,0,0,0,586
Turkey,TUR,2023,0,2214,5838409,117,0,0,5840740
Turkey,TUR,1900,0,0,100195,0,0,0,100195
Turkey,TUR,1903,0,0,4402950,0,0,0,4402950
Turkey,TUR,1912,0,0,633420,0,0,0,633420
Turkey,TUR,1914,0,0,2789326,0,0,0,2789326
Turkey,TUR,1924,0,0,78112,0,0,0,78112
Turkey,TUR,1925,0,0,143103,0,0,0,143103
Turkey,TUR,1928,0,0,34483,0,0,0,34483
Turkey,TUR,1934,0,0,75962,0,0,0,75962
Turkey,TUR,1935,0,0,335826,0,0,0,335826
Turkey,TUR,1938,0,0,87867,0,0,0,87867
Turkey,TUR,1939,0,0,19142012,0,0,0,19142012
Turkey,TUR,1940,0,0,30180,0,0,0,30180
Turkey,TUR,1941,0,0,249062,0,0,0,249062
Turkey,TUR,1942,0,0,1668705,0,0,0,1668705
Turkey,TUR,1943,0,0,2780294,0,0,0,2780294
Turkey,TUR,1944,0,0,2130921,0,0,0,2130921
Turkey,TUR,1945,0,0,313704,0,0,0,313704
Turkey,TUR,1946,0,0,437954,0,0,0,437954
Turkey,TUR,1949,0,0,155926,0,0,0,155926
Turkey,TUR,1950,0,0,9534,0,0,0,9534
Turkey,TUR,1951,0,0,25093,0,0,0,25093
Turkey,TUR,1952,0,0,98214,0,0,0,98214
Turkey,TUR,1953,0,0,545160,0,0,0,545160
Turkey,TUR,1966,0,0,755297,0,0,0,755297
Turkey,TUR,1967,0,0,84780,0,0,0,84780
Turkey,TUR,1969,0,0,15264,0,0,0,15264
Turkey,TUR,1970,0,0,305563,0,0,0,305563
Turkey,TUR,1971,0,0,257151,0,0,0,257151
Turkey,TUR,1975,0,0,601156,0,0,0,601156
Turkey,TUR,1976,0,0,949606,0,0,16543,966149
Turkey,TUR,1977,0,0,7249,0,0,0,7249
Turkey,TUR,1978,0,0,0,0,0,0,0
Turkey,TUR,1979,0,0,0,0,0,0,0
Turkey,TUR,1983,0,0,286222,0,0,0,286222
Turkey,TUR,1985,0,0,0,0,0,2644,2644
Turkey,TUR,1986,0,0,2987,0,0,0,2987
Turkey,TUR,1992,0,0,115982,0,0,46357,162339
Turkey,TUR,1996,0,0,0,0,0,0,0
Turkey,TUR,1999,0,0,2845901,0,0,0,2845901
Turkey,TUR,2010,0,0,6968,0,0,1776,8744
Turkey,TUR,2014,0,0,0,0,0,0,0
Turkey,TUR,2017,0,0,0,0,0,0,0
Turkey,TUR,1972,0,0,0,8067,0,0,8067
Turkey,TUR,1994,0,0,0,5145,0,0,5145
Turkey,TUR,1987,0,0,0,0,5854,0,5854
Turkey,TUR,1993,0,0,0,0,0,23562,23562
Turkey,TUR,2013,0,0,0,0,0,914,914
Turkey,TUR,2018,0,0,0,0,0,2898,2898
Turkey,TUR,2008,0,0,0,0,0,280,280
Turkmenistan,TKM,1993,0,0,0,0,0,0,0
Turkmenistan,TKM,2000,0,0,24075,0,0,0,24075
Turks and Caicos Islands,TCA,1985,0,0,0,0,0,0,0
Turks and Caicos Islands,TCA,1990,0,0,0,0,0,0,0
Turks and Caicos Islands,TCA,2004,0,0,0,0,0,0,0
Turks and Caicos Islands,TCA,2008,0,0,0,1457195,0,0,1457195
Turks and Caicos Islands,TCA,2017,0,0,0,0,0,0,0
Tuvalu,TUV,2011,0,0,0,0,0,0,0
Tuvalu,TUV,2021,0,0,0,0,0,0,0
Tuvalu,TUV,1972,0,0,0,10140274,0,0,10140274
Tuvalu,TUV,1984,0,0,0,0,0,0,0
Tuvalu,TUV,1987,0,0,0,0,0,0,0
Tuvalu,TUV,1990,0,0,0,0,0,0,0
Tuvalu,TUV,1993,0,0,0,0,0,0,0
Tuvalu,TUV,2015,0,0,0,0,0,0,0
Tuvalu,TUV,2020,0,0,0,0,0,0,0
Uganda,UGA,1967,0,0,0,0,0,0,0
Uganda,UGA,1979,0,0,0,0,0,0,0
Uganda,UGA,1987,0,0,0,0,0,0,0
Uganda,UGA,1998,0,0,0,0,0,0,0
Uganda,UGA,1999,49400,0,0,0,0,0,49400
Uganda,UGA,2002,30926,6655,0,0,0,0,37581
Uganda,UGA,2005,0,0,0,0,0,0,0
Uganda,UGA,2008,0,16060,0,0,0,0,16060
Uganda,UGA,2010,0,0,0,0,0,119969,119969
Uganda,UGA,2022,521698,12064,0,0,0,4021,537783
Uganda,UGA,1997,0,45710,0,0,0,9142,54852
Uganda,UGA,2001,0,404,0,0,0,4442,4846
Uganda,UGA,2003,0,9486,0,0,0,0,9486
Uganda,UGA,2004,0,0,0,0,0,0,0
Uganda,UGA,2006,0,1043,0,0,0,0,1043
Uganda,UGA,2007,0,11137,0,0,0,0,11137
Uganda,UGA,2011,0,8109,0,6908,0,0,15017
Uganda,UGA,2012,0,0,0,0,0,5252,5252
Uganda,UGA,2013,0,3685,0,0,0,0,3685
Uganda,UGA,2016,0,0,1032,0,0,3871,4903
Uganda,UGA,2017,0,4237,0,0,0,0,4237
Uganda,UGA,2019,0,29570,0,0,0,20489,50059
Uganda,UGA,2020,0,6080,0,1802,0,0,7882
Uganda,UGA,2021,0,1090,0,0,0,0,1090
Uganda,UGA,2023,0,4734,0,0,0,0,4734
Uganda,UGA,1966,0,0,114226,0,0,0,114226
Uganda,UGA,1988,0,0,0,0,0,0,0
Uganda,UGA,1990,0,0,0,0,0,0,0
Uganda,UGA,1994,0,0,3478,0,0,0,3478
Uganda,UGA,2000,0,0,0,0,0,0,0
Uganda,UGA,2018,0,0,0,0,0,12285,12285
Ukraine,UKR,2012,0,0,0,0,42946,0,42946
Ukraine,UKR,1993,0,1738,0,0,0,0,1738
Ukraine,UKR,1995,0,0,0,0,0,0,0
Ukraine,UKR,1996,0,0,0,0,0,0,0
Ukraine,UKR,1997,0,0,0,2193,0,0,2193
Ukraine,UKR,1998,0,3618,0,0,0,0,3618
Ukraine,UKR,2001,0,1859,0,0,0,0,1859
Ukraine,UKR,2003,0,0,0,0,0,0,0
Ukraine,UKR,2005,0,0,0,0,170743,0,170743
Ukraine,UKR,2006,0,429,0,0,0,0,429
Ukraine,UKR,2008,0,8250,0,0,1085,0,9335
Ukraine,UKR,2010,0,1313,0,0,0,0,1313
Ukraine,UKR,2013,0,441,0,0,0,0,441
Ukraine,UKR,2016,0,669,0,0,8253,0,8922
Ukraine,UKR,2020,0,683,0,0,0,3644,4327
Ukraine,UKR,2023,0,0,0,0,0,0,0
Ukraine,UKR,1992,0,0,0,0,0,0,0
Ukraine,UKR,2000,0,0,0,2046,0,0,2046
Ukraine,UKR,2007,0,0,0,0,0,0,0
Ukraine,UKR,2018,0,0,0,0,0,0,0
Ukraine,UKR,2021,0,0,0,230,0,0,230
Ukraine,UKR,2009,0,0,0,0,5887,0,5887
Ukraine,UKR,2017,0,0,0,0,8285,0,8285
United Arab Emirates,ARE,2017,0,0,0,0,0,0,0
United Kingdom,GBR,2022,0,0,0,889,513858,0,514747
United Kingdom,GBR,1952,0,6735,0,0,0,792318,799053
United Kingdom,GBR,1977,0,1067,0,0,0,0,1067
United Kingdom,GBR,1993,0,694,0,0,0,0,694
United Kingdom,GBR,1994,0,1211,0,0,0,0,1211
United Kingdom,GBR,1997,0,172,0,0,2403,0,2575
United Kingdom,GBR,1998,0,856,0,5989,0,0,6845
United Kingdom,GBR,1999,0,0,0,1876,0,0,1876
United Kingdom,GBR,2000,0,0,0,2719,0,0,2719
United Kingdom,GBR,2001,0,0,0,0,0,0,0
United Kingdom,GBR,2002,0,168,0,2359,0,0,2527
United Kingdom,GBR,2004,0,0,0,0,0,0,0
United Kingdom,GBR,2007,0,2285,0,2122,0,0,4407
United Kingdom,GBR,2008,0,1296,0,0,0,0,1296
United Kingdom,GBR,2009,0,482,0,321,482,0,1285
United Kingdom,GBR,2012,0,1254,0,0,0,0,1254
United Kingdom,GBR,2013,0,311,0,1711,118192,0,120214
United Kingdom,GBR,2014,0,0,0,772,0,0,772
United Kingdom,GBR,2015,0,0,0,460,0,0,460
United Kingdom,GBR,2017,0,0,0,0,0,0,0
United Kingdom,GBR,2019,0,150,0,0,24858,0,25008
United Kingdom,GBR,2020,0,0,0,298,381154,0,381452
United Kingdom,GBR,1990,0,0,0,14508,0,0,14508
United Kingdom,GBR,1968,0,0,0,3625,0,0,3625
United Kingdom,GBR,1972,0,0,0,0,0,0,0
United Kingdom,GBR,1976,0,0,0,0,0,0,0
United Kingdom,GBR,1981,0,0,0,2128,0,0,2128
United Kingdom,GBR,1983,0,0,0,885,0,0,885
United Kingdom,GBR,1984,0,0,0,3889,0,0,3889
United Kingdom,GBR,1986,0,0,0,0,0,0,0
United Kingdom,GBR,1987,0,0,0,3519,0,0,3519
United Kingdom,GBR,1989,0,0,0,2278,0,0,2278
United Kingdom,GBR,1991,0,0,0,8368,0,0,8368
United Kingdom,GBR,1995,0,0,0,1554,0,0,1554
United Kingdom,GBR,1996,0,0,0,861,0,0,861
United Kingdom,GBR,2005,0,0,0,1656,166,0,1822
United Kingdom,GBR,2010,0,0,0,0,0,0,0
United Kingdom,GBR,2018,0,0,0,0,0,0,0
United Kingdom,GBR,2021,0,0,0,149,0,0,149
United Kingdom,GBR,2003,0,0,0,0,50461,0,50461
United Kingdom,GBR,1966,0,0,0,0,0,25660,25660
United States,USA,1933,0,0,9453,3260,0,0,12713
United States,USA,1988,0,0,0,1114,0,0,1114
United States,USA,1991,0,596,80,3458,0,1113,5247
United States,USA,1999,0,0,0,8131,9205,36,17372
United States,USA,2000,0,283,0,3718,1239,496,5736
United States,USA,2002,0,902,0,6589,486,0,7977
United States,USA,2007,0,2643,0,8093,0,264,11000
United States,USA,2011,0,542,0,24277,701,255,25775
United States,USA,2012,0,63,0,6000,3884,95,10042
United States,USA,2014,0,62,31,4223,652,1397,6365
United States,USA,2015,0,3019,0,6716,0,370,10105
United States,USA,2017,0,910,0,7914,0,1364,10188
United States,USA,2018,0,211,0,4757,0,3763,8731
United States,USA,2020,1340,30,0,5209,0,953,7532
United States,USA,2021,0,1721,0,14659,6795,148,23323
United States,USA,2022,4020,1242,59,8986,0,177,14484
United States,USA,1903,0,31571,0,12376,0,0,43947
United States,USA,1909,0,8122,0,44107,0,0,52229
United States,USA,1927,0,21384,0,7563,0,0,28947
United States,USA,1936,0,15959,0,36306,95194,0,147459
United States,USA,1937,0,10856,0,0,0,0,10856
United States,USA,1943,0,0,0,0,0,0,0
United States,USA,1948,0,3821,0,2918,0,0,6739
United States,USA,1950,0,2225,0,18343,0,0,20568
United States,USA,1951,0,2722,0,0,4582,0,7304
United States,USA,1955,0,4592,0,22652,6640,0,33884
United States,USA,1964,0,5820,6995,9772,0,0,22587
United States,USA,1969,0,5812,0,36137,0,0,41949
United States,USA,1972,0,11548,0,12473,487,19490,43998
United States,USA,1973,0,2701,0,2412,1061,0,6174
United States,USA,1976,0,6518,0,0,0,0,6518
United States,USA,1977,0,6498,0,4224,0,0,10722
United States,USA,1978,0,1239,0,9868,0,0,11107
United States,USA,1980,0,1613,0,538,56467,4033,62651
United States,USA,1981,0,1329,0,1329,0,0,2658
United States,USA,1982,0,482,0,22061,0,0,22543
United States,USA,1983,0,434,87,5729,8160,0,14410
United States,USA,1984,0,1203,0,22211,0,0,23414
United States,USA,1985,0,510,0,15437,0,0,15947
United States,USA,1986,0,547,0,42,2021,0,2610
United States,USA,1990,0,1532,0,6530,443,0,8505
United States,USA,1993,0,3787,77,11245,1855,116,17080
United States,USA,1994,0,1411,2288,6291,0,496,10486
United States,USA,1995,0,414,0,5646,26726,0,32786
United States,USA,1996,0,2677,0,10670,0,37,13384
United States,USA,1997,0,2643,0,6608,0,0,9251
United States,USA,1998,0,1124,0,7359,4713,73,13269
United States,USA,2001,0,420,35,2872,1962,70,5359
United States,USA,2003,0,824,69,5908,0,1134,7935
United States,USA,2004,0,34,0,7314,102,0,7450
United States,USA,2005,0,1785,0,63401,1112,168,66466
United States,USA,2006,0,1334,0,3103,6272,167,10876
United States,USA,2008,0,1439,0,8440,0,33,9912
United States,USA,2009,0,357,0,2399,1880,65,4701
United States,USA,2010,0,643,0,3792,0,0,4435
United States,USA,2013,0,971,0,4384,595,689,6639
United States,USA,2016,0,1650,0,6082,0,489,8221
United States,USA,2019,0,299,0,4158,0,90,4547
United States,USA,1906,0,0,83502,35548,0,0,119050
United States,USA,1915,0,0,619,54205,0,0,54824
United States,USA,1925,0,0,1163,66140,0,0,67303
United States,USA,1940,0,0,695,3863,0,0,4558
United States,USA,1946,0,0,11783,2357,0,0,14140
United States,USA,1949,0,0,548,5957,0,0,6505
United States,USA,1952,0,0,915,18242,0,0,19157
United States,USA,1959,0,0,1615,4096,0,0,5711
United States,USA,1960,0,0,3462,2838,0,0,6300
United States,USA,1965,0,0,369,30047,0,0,30416
United States,USA,1971,0,0,3203,7787,0,0,10990
United States,USA,1975,0,0,0,4828,0,0,4828
United States,USA,1987,0,0,334,6296,3335,0,9965
United States,USA,1989,0,0,2735,4409,3429,0,10573
United States,USA,1992,0,0,39,3801,0,0,3840
United States,USA,1900,0,0,0,801819,0,0,801819
United States,USA,1910,0,0,0,3328,0,0,3328
United States,USA,1913,0,0,0,77681,0,0,77681
United States,USA,1918,0,0,0,3367,0,99039,102406
United States,USA,1919,0,0,0,48819,0,0,48819
United States,USA,1920,0,0,0,21560,0,0,21560
United States,USA,1926,0,0,0,23639,0,0,23639
United States,USA,1928,0,0,0,157285,0,0,157285
United States,USA,1932,0,0,0,30526,0,0,30526
United States,USA,1935,0,0,0,32785,0,0,32785
United States,USA,1938,0,0,0,47211,0,15737,62948
United States,USA,1944,0,0,0,28631,0,8883,37514
United States,USA,1945,0,0,0,14191,0,0,14191
United States,USA,1947,0,0,0,21694,0,0,21694
United States,USA,1953,0,0,0,30106,0,0,30106
United States,USA,1954,0,0,0,14096,0,0,14096
United States,USA,1956,0,0,0,14141,0,670,14811
United States,USA,1957,0,0,0,28092,0,0,28092
United States,USA,1958,0,0,0,8169,0,0,8169
United States,USA,1961,0,0,0,8152,0,0,8152
United States,USA,1962,0,0,0,8685,0,0,8685
United States,USA,1963,0,0,0,12402,8123,0,20525
United States,USA,1966,0,0,0,15117,13658,0,28775
United States,USA,1967,0,0,0,14191,0,0,14191
United States,USA,1968,0,0,0,8123,0,0,8123
United States,USA,1970,0,0,0,1847,0,0,1847
United States,USA,1974,0,0,0,16820,0,0,16820
United States,USA,1979,0,0,0,8437,0,0,8437
United States,USA,2023,0,0,0,3382,706,5382,9470
U.S. Virgin Islands,VIR,1989,0,0,0,0,0,0,0
U.S. Virgin Islands,VIR,1995,0,0,0,676538,0,0,676538
U.S. Virgin Islands,VIR,1998,0,0,0,0,0,0,0
U.S. Virgin Islands,VIR,1999,0,0,0,278185,0,0,278185
U.S. Virgin Islands,VIR,2004,0,0,0,0,0,0,0
U.S. Virgin Islands,VIR,2017,0,0,0,687218,0,0,687218
Uruguay,URY,1999,0,0,0,3050,0,0,3050
Uruguay,URY,2018,0,0,0,0,0,0,0
Uruguay,URY,2022,0,0,0,0,0,0,0
Uruguay,URY,1967,0,29284,0,0,0,0,29284
Uruguay,URY,1986,0,0,0,0,0,0,0
Uruguay,URY,1991,0,0,0,0,0,0,0
Uruguay,URY,1992,0,0,0,0,0,0,0
Uruguay,URY,1998,0,3065,0,0,0,0,3065
Uruguay,URY,2000,0,0,0,0,21262,0,21262
Uruguay,URY,2001,0,0,0,0,0,0,0
Uruguay,URY,2002,0,0,0,6049,0,0,6049
Uruguay,URY,2003,0,0,0,0,0,0,0
Uruguay,URY,2007,0,6008,0,0,0,0,6008
Uruguay,URY,2009,0,2990,0,0,0,0,2990
Uruguay,URY,2015,0,5877,0,0,0,0,5877
Uruguay,URY,2016,0,23435,0,0,0,0,23435
Uruguay,URY,2017,0,0,0,0,0,0,0
Uruguay,URY,2019,0,0,0,0,0,0,0
Uruguay,URY,2020,0,0,0,0,0,0,0
Uruguay,URY,1993,0,0,0,0,0,0,0
Uruguay,URY,1997,0,0,0,3082,0,0,3082
Uruguay,URY,2005,0,0,0,21099,0,0,21099
Uruguay,URY,2004,0,0,0,0,0,0,0
Uruguay,URY,2010,0,0,0,0,11931,0,11931
Uzbekistan,UZB,2000,0,0,0,0,0,0,0
Uzbekistan,UZB,2005,0,0,0,0,0,0,0
Uzbekistan,UZB,2020,0,1193,0,0,0,0,1193
Uzbekistan,UZB,2022,0,1444,0,0,0,0,1444
Uzbekistan,UZB,1992,0,0,4169,0,0,463,4632
Uzbekistan,UZB,2011,0,0,4474,0,0,0,4474
Uzbekistan,UZB,1999,0,0,0,0,0,9755,9755
Uzbekistan,UZB,2021,0,0,0,0,0,2347,2347
Vanuatu,VUT,2002,0,0,0,0,0,0,0
Vanuatu,VUT,2009,0,0,0,0,0,0,0
Vanuatu,VUT,1990,0,0,0,0,0,0,0
Vanuatu,VUT,1994,0,0,0,0,0,0,0
Vanuatu,VUT,1997,0,0,0,0,0,0,0
Vanuatu,VUT,1999,0,0,640171,1707122,0,0,2347293
Vanuatu,VUT,1940,0,0,0,0,0,0,0
Vanuatu,VUT,1951,0,0,0,19067958,0,0,19067958
Vanuatu,VUT,1959,0,0,0,0,0,0,0
Vanuatu,VUT,1972,0,0,0,431490,0,0,431490
Vanuatu,VUT,1975,0,0,0,0,0,0,0
Vanuatu,VUT,1977,0,0,0,0,0,0,0
Vanuatu,VUT,1979,0,0,0,0,0,0,0
Vanuatu,VUT,1981,0,0,0,0,0,0,0
Vanuatu,VUT,1985,0,0,0,676006,0,0,676006
Vanuatu,VUT,1987,0,0,0,3429184,0,0,3429184
Vanuatu,VUT,1988,0,0,0,0,0,69666,69666
Vanuatu,VUT,1992,0,0,0,126109,0,0,126109
Vanuatu,VUT,1993,0,0,0,246057,0,0,246057
Vanuatu,VUT,1998,0,0,0,0,0,0,0
Vanuatu,VUT,2001,0,0,0,101501,0,0,101501
Vanuatu,VUT,2004,0,0,0,94148,0,0,94148
Vanuatu,VUT,2011,0,0,0,0,0,0,0
Vanuatu,VUT,2014,0,0,0,444540,0,0,444540
Vanuatu,VUT,2015,0,0,0,397902,0,0,397902
Vanuatu,VUT,2017,0,0,0,0,0,0,0
Vanuatu,VUT,2020,0,0,0,96248,0,0,96248
Vanuatu,VUT,2023,0,0,0,0,0,0,0
Vanuatu,VUT,2005,0,0,0,0,0,0,0
Vanuatu,VUT,2006,0,0,0,0,0,0,0
Vanuatu,VUT,2008,0,0,0,0,0,0,0
Vanuatu,VUT,2018,0,0,0,0,0,0,0
Vanuatu,VUT,2021,0,0,0,0,0,0,0
Venezuela,VEN,2009,0,0,0,0,0,0,0
Venezuela,VEN,1967,0,0,232134,0,0,0,232134
Venezuela,VEN,1985,0,21836,0,0,0,0,21836
Venezuela,VEN,1987,0,21824,0,0,0,52377,74201
Venezuela,VEN,1988,0,35105,0,5851,0,0,40956
Venezuela,VEN,1994,0,12014,0,0,0,8318,20332
Venezuela,VEN,1996,0,0,0,0,0,0,0
Venezuela,VEN,1997,0,1302,34726,0,0,0,36028
Venezuela,VEN,1999,0,12519316,0,0,0,0,12519316
Venezuela,VEN,2000,0,6141,0,0,0,0,6141
Venezuela,VEN,2002,0,1579,0,0,0,0,1579
Venezuela,VEN,2003,0,388,0,0,0,0,388
Venezuela,VEN,2004,0,13345,0,1906,0,0,15251
Venezuela,VEN,2005,0,36372,0,0,0,0,36372
Venezuela,VEN,2006,0,0,0,0,0,0,0
Venezuela,VEN,2008,0,2864,0,0,0,0,2864
Venezuela,VEN,2010,0,14278,0,2786,0,0,17064
Venezuela,VEN,2011,0,5843,0,0,0,0,5843
Venezuela,VEN,2012,0,0,0,0,0,0,0
Venezuela,VEN,2015,0,0,0,0,0,0,0
Venezuela,VEN,2016,0,0,0,0,0,0,0
Venezuela,VEN,2018,0,671,0,0,0,0,671
Venezuela,VEN,2019,0,2071,0,0,0,0,2071
Venezuela,VEN,2020,0,1053,0,0,0,0,1053
Venezuela,VEN,2021,0,16312,0,0,0,0,16312
Venezuela,VEN,2022,0,11660,0,0,0,38514,50174
Venezuela,VEN,2023,0,4161,0,0,0,0,4161
Venezuela,VEN,1950,0,0,182195,0,0,0,182195
Venezuela,VEN,1980,0,0,0,0,0,0,0
Venezuela,VEN,1986,0,0,1680,0,0,0,1680
Venezuela,VEN,1989,0,0,0,0,0,0,0
Venezuela,VEN,1993,0,0,0,47232,0,0,47232
Venezuela,VEN,1962,0,0,0,0,0,34270,34270
Venezuela,VEN,1981,0,0,0,0,0,12789,12789
Vietnam,VNM,1987,0,0,0,19639,0,0,19639
Vietnam,VNM,1997,0,0,0,485415,0,0,485415
Vietnam,VNM,1999,0,100994,0,1280,0,0,102274
Vietnam,VNM,2002,0,18229,0,0,0,0,18229
Vietnam,VNM,2005,0,23093,0,13952,0,0,37045
Vietnam,VNM,2015,0,3688,0,1952,0,0,5640
Vietnam,VNM,2019,0,5743,0,418,0,0,6161
Vietnam,VNM,1964,0,109562,0,1917326,0,0,2026888
Vietnam,VNM,1966,0,8075,0,0,0,0,8075
Vietnam,VNM,1970,0,56524,0,0,0,0,56524
Vietnam,VNM,1978,0,14595,0,0,0,0,14595
Vietnam,VNM,1980,0,17746,0,58148,0,0,75894
Vietnam,VNM,1984,0,5650,0,26538,0,0,32188
Vietnam,VNM,1985,0,15549,0,133420,0,0,148969
Vietnam,VNM,1986,0,26951,0,71054,0,0,98005
Vietnam,VNM,1990,0,12255,0,15244,0,0,27499
Vietnam,VNM,1991,0,28526,0,43447,0,0,71973
Vietnam,VNM,1992,0,8024,0,4442,0,28658,41124
Vietnam,VNM,1993,0,8992,0,28942,0,0,37934
Vietnam,VNM,1994,0,42758,0,4138,0,2897,49793
Vietnam,VNM,1995,0,34301,0,2169,0,0,36470
Vietnam,VNM,1996,0,29621,0,105275,0,0,134896
Vietnam,VNM,1998,0,5834,0,47713,0,0,53547
Vietnam,VNM,2000,0,62784,0,2911,0,9240,74935
Vietnam,VNM,2001,0,42472,0,6640,0,0,49112
Vietnam,VNM,2003,0,15710,0,0,0,0,15710
Vietnam,VNM,2004,0,11663,0,8504,0,2794,22961
Vietnam,VNM,2006,0,21203,0,47766,0,0,68969
Vietnam,VNM,2007,0,27135,0,11326,0,0,38461
Vietnam,VNM,2008,0,18342,0,29674,0,0,48016
Vietnam,VNM,2009,0,4278,0,35383,0,1503,41164
Vietnam,VNM,2010,0,21279,0,4004,0,0,25283
Vietnam,VNM,2011,0,13809,0,1811,0,0,15620
Vietnam,VNM,2012,0,3807,0,4255,0,0,8062
Vietnam,VNM,2013,0,15620,0,8198,0,0,23818
Vietnam,VNM,2016,0,9772,0,7624,0,0,17396
Vietnam,VNM,2017,0,14569,0,15633,0,0,30202
Vietnam,VNM,2018,0,7059,0,7059,0,0,14118
Vietnam,VNM,2020,0,517,0,31558,0,0,32075
Vietnam,VNM,2021,0,2462,0,1129,0,0,3591
Vietnam,VNM,2022,0,3055,0,3055,0,0,6110
Vietnam,VNM,2023,0,405,0,101,0,0,506
Vietnam,VNM,1953,0,0,0,372844,0,0,372844
Vietnam,VNM,1956,0,0,0,19287,0,0,19287
Vietnam,VNM,1971,0,0,0,26097,0,0,26097
Vietnam,VNM,1973,0,0,0,22276,0,0,22276
Vietnam,VNM,1977,0,0,0,0,0,0,0
Vietnam,VNM,1982,0,0,0,12583,0,0,12583
Vietnam,VNM,1983,0,0,0,128746,0,0,128746
Vietnam,VNM,1988,0,0,0,24517,0,0,24517
Vietnam,VNM,1989,0,0,0,146487,0,0,146487
Vietnam,VNM,2014,0,0,0,4165,0,0,4165
Wallis and Futuna,WLF,1993,0,0,3590922,0,0,0,3590922
Wallis and Futuna,WLF,1965,0,0,0,0,0,0,0
Wallis and Futuna,WLF,1966,0,0,0,0,0,0,0
Wallis and Futuna,WLF,1986,0,0,0,772678,0,0,772678
Wallis and Futuna,WLF,2012,0,0,0,0,0,0,0
Yemen,YEM,1991,0,0,7196,0,0,0,7196
Yemen,YEM,1993,0,20683,0,0,0,0,20683
Yemen,YEM,1996,0,207652,0,0,0,0,207652
Yemen,YEM,1998,0,39754,0,0,0,0,39754
Yemen,YEM,1999,0,0,0,0,0,0,0
Yemen,YEM,2001,0,17238,0,15671,0,0,32909
Yemen,YEM,2002,0,26957,0,0,0,0,26957
Yemen,YEM,2003,0,7430,0,0,0,0,7430
Yemen,YEM,2005,0,10319,0,0,0,30487,40806
Yemen,YEM,2006,0,13657,0,0,0,0,13657
Yemen,YEM,2007,0,41075,0,0,0,2650,43725
Yemen,YEM,2008,0,38579,0,0,0,0,38579
Yemen,YEM,2010,0,8891,0,0,0,0,8891
Yemen,YEM,2013,0,14824,0,0,0,0,14824
Yemen,YEM,2016,0,6832,0,0,0,6832,13664
Yemen,YEM,2017,0,16648,0,0,0,0,16648
Yemen,YEM,2019,0,8242,0,0,0,0,8242
Yemen,YEM,2020,0,20134,0,0,0,0,20134
Yemen,YEM,2021,0,13947,0,0,0,0,13947
Yemen,YEM,2022,0,26709,0,0,0,0,26709
Yemen,YEM,2023,0,11321,0,0,0,0,11321
Yemen,YEM,2015,0,0,0,9118,0,0,9118
Yemen,YEM,2018,0,0,0,15914,0,0,15914
Yemen,YEM,2009,0,0,0,0,0,4578,4578
Zambia,ZMB,1981,0,0,0,0,0,0,0
Zambia,ZMB,1983,0,0,0,0,0,0,0
Zambia,ZMB,1990,0,0,0,0,0,0,0
Zambia,ZMB,1995,0,0,0,0,0,0,0
Zambia,ZMB,2005,0,0,0,0,0,0,0
Zambia,ZMB,2019,0,2176,0,0,0,0,2176
Zambia,ZMB,2021,0,0,0,0,0,0,0
Zambia,ZMB,1978,0,20403,0,0,0,0,20403
Zambia,ZMB,1989,0,0,0,0,0,0,0
Zambia,ZMB,1998,0,0,0,0,0,0,0
Zambia,ZMB,2000,0,0,0,0,0,0,0
Zambia,ZMB,2001,0,4906,0,0,0,0,4906
Zambia,ZMB,2003,0,3691,0,0,0,0,3691
Zambia,ZMB,2004,0,1788,0,0,0,0,1788
Zambia,ZMB,2007,0,11288,0,0,0,0,11288
Zambia,ZMB,2008,0,3112,0,0,0,0,3112
Zambia,ZMB,2009,0,23277,0,0,0,0,23277
Zambia,ZMB,2010,0,0,0,0,0,6525,6525
Zambia,ZMB,2011,0,0,0,0,0,0,0
Zambia,ZMB,2013,0,0,0,0,0,0,0
Zambia,ZMB,2014,0,0,0,0,0,0,0
Zambia,ZMB,2020,0,1585,0,0,0,0,1585
Zambia,ZMB,2022,0,1499,0,0,0,0,1499
Zambia,ZMB,2023,0,0,0,0,0,0,0
Zimbabwe,ZWE,1981,0,0,0,0,0,0,0
Zimbabwe,ZWE,1990,0,0,0,0,0,0,0
Zimbabwe,ZWE,1998,0,31173,0,0,0,0,31173
Zimbabwe,ZWE,2001,0,10914,0,0,0,0,10914
Zimbabwe,ZWE,2007,0,21686,0,0,0,0,21686
Zimbabwe,ZWE,2010,0,0,0,0,0,0,0
Zimbabwe,ZWE,2013,0,92214,0,0,0,0,92214
Zimbabwe,ZWE,2017,0,0,0,170157,0,0,170157
Zimbabwe,ZWE,2021,0,0,0,1876,0,0,1876
Zimbabwe,ZWE,2000,0,59148,0,0,0,0,59148
Zimbabwe,ZWE,2003,0,1656,0,6625,0,0,8281
Zimbabwe,ZWE,2011,0,0,0,0,0,0,0
Zimbabwe,ZWE,2014,0,10104,0,0,0,0,10104
Zimbabwe,ZWE,2019,0,16933,0,408998,0,0,425931
Zimbabwe,ZWE,2022,0,0,0,0,0,0,0
Zimbabwe,ZWE,1975,0,0,0,18041,0,0,18041
Zimbabwe,ZWE,2015,0,0,0,7065,0,0,7065
Zimbabwe,ZWE,2016,0,0,0,21449,0,0,21449
Zimbabwe,ZWE,2023,0,0,0,1200,0,0,1200
